barcode	labels
S3_ATGAGGGAGTCTTGCA	FBN1+ FIB
S3_GTACGTACAAATTGCC	FBN1+ FIB
S3_CTCGTCAGTGTTGAGG	Inflam. FIB
S3_ATTCTACGTAATCGTC	FBN1+ FIB
S3_CTGCCTATCAATCACG	FBN1+ FIB
S3_TAGTGGTAGGATGCGT	FBN1+ FIB
S3_GTTCGGGGTCTGGTCG	COL11A1+ FIB
S3_AACTCTTGTAAGTGGC	FBN1+ FIB
S3_TGCGCAGTCAGCAACT	FBN1+ FIB
S3_AAAGATGAGCCACGTC	COL11A1+ FIB
S3_ACACTGAGTACTTGAC	APOE+ FIB
S3_TGCGCAGTCGCAGGCT	APOE+ FIB
S3_CGAACATTCTGATTCT	FBN1+ FIB
S3_TACTCGCTCCATGAGT	APOE+ FIB
S3_GCATGCGCATCCCATC	FBN1+ FIB
S3_GACGCGTAGCCACCTG	FBN1+ FIB
S3_ATGCGATCAAATCCGT	APOE+ FIB
S3_CGTCCATCAAGCCGCT	APOE+ FIB
S3_CGACTTCTCTCGCATC	FBN1+ FIB
S3_CAGCGACTCAGGATCT	FBN1+ FIB
S3_AGATCTGAGTGGACGT	FBN1+ FIB
S3_ACATCAGGTAGTAGTA	FBN1+ FIB
S3_TAAGCGTAGGTGATAT	FBN1+ FIB
S3_TACGGGCCATTTGCTT	FBN1+ FIB
S3_TTCGGTCTCAGTCCCT	APOE+ FIB
S3_TGCGTGGGTTCGAATC	FBN1+ FIB
S3_TTTGGTTCATGTCTCC	FBN1+ FIB
S3_CAACTAGGTCTGGTCG	FBN1+ FIB
S3_CTAGAGTCAGGTCGTC	FBN1+ FIB
S3_CATCCACCAAGTAGTA	FBN1+ FIB
S3_GTCGTAAGTCTGATTG	FBN1+ FIB
S3_CCTTCCCCAGCGTCCA	FBN1+ FIB
S3_CAAGATCTCTGTGCAA	APOE+ FIB
S3_CCTTACGTCCCATTTA	APOE+ FIB
S3_GCTTCCAAGATCCTGT	FBN1+ FIB
S3_CGGACGTTCCCGGATG	FBN1+ FIB
S3_CATCCACCACGGACAA	FBN1+ FIB
S3_ACTTTCAAGAGTACCG	APOE+ FIB
S3_ACGCCAGTCGTAGATC	FBN1+ FIB
S3_TGCCCTAGTTCCATGA	FBN1+ FIB
S3_GGAGCAACAGATGGCA	FBN1+ FIB
S3_CACAGTAAGTTTGCGT	FBN1+ FIB
S3_CATCAGATCTTCATGT	FBN1+ FIB
S3_GACCTGGAGCATCATC	APOE+ FIB
S3_TTTACTGAGCGATAGC	APOE+ FIB
S3_GCATGATCATATGAGA	APOE+ FIB
S3_TAGTGGTAGACATAAC	APOE+ FIB
S3_AACTTTCCAGTCAGCC	FBN1+ FIB
S3_CACCTTGAGGGCTCTC	APOE+ FIB
S3_ATCTACTTCAAGGTAA	APOE+ FIB
S3_GGGATGACAGGTGCCT	APOE+ FIB
S3_GGAGCAATCGGACAAG	FBN1+ FIB
S3_ATCATCTAGTATCTCG	FBN1+ FIB
S3_AGTTGGTTCTTGTACT	FBN1+ FIB
S3_AACACGTCAATACGCT	FBN1+ FIB
S3_CACAAACAGCACCGTC	FBN1+ FIB
S3_TAAGCGTGTTAAAGTG	APOE+ FIB
S3_GGGATGAGTCTAGGTT	APOE+ FIB
S3_CTACCCATCGTATCAG	COL11A1+ FIB
S3_TGACAACTCCAGGGCT	APOE+ FIB
S3_TGGCTGGGTGGTAACG	APOE+ FIB
S3_TGCCCTAAGCAATCTC	APOE+ FIB
S3_CTCGAGGCATGGTAGG	COL11A1+ FIB
S3_GTGCGGTCAGGCTCAC	FBN1+ FIB
S3_CGTTAGACAGTATGCT	APOE+ FIB
S3_TGACAACCATGTTGAC	COL11A1+ FIB
S3_ACAGCTAGTGGTACAG	FBN1+ FIB
S3_AAAGTAGCACGGCGTT	FBN1+ FIB
S3_ATCTACTCACTGTGTA	FBN1+ FIB
S3_TGATTTCCACTTCGAA	APOE+ FIB
S3_CGCTTCAAGCTACCTA	APOE+ FIB
S3_CTGATAGTCTCACATT	APOE+ FIB
S3_TCAGCTCGTTAGGGTG	FBN1+ FIB
S3_AGCGTATCACCAACCG	APOE+ FIB
S3_ACAGCTACAGTTTACG	FBN1+ FIB
S3_CCCAGTTTCAGAGGTG	APOE+ FIB
S3_CAGGTGCGTATGGTTC	APOE+ FIB
S3_CCCATACCAAACCTAC	APOE+ FIB
S3_CTTACCGAGATAGCAT	APOE+ FIB
S3_CTACATTCACTGCCAG	COL11A1+ FIB
S3_CGTAGGCGTAGATTAG	APOE+ FIB
S3_TCTGGAACATGTTCCC	FBN1+ FIB
S3_CAGCGACCAAGTTCTG	FBN1+ FIB
S3_AAAGTAGGTGCAGGTA	APOE+ FIB
S3_AACGTTGAGGGTTCCC	APOE+ FIB
S3_GGTATTGTCAACGGCC	FBN1+ FIB
S3_CTTAACTTCACGACTA	APOE+ FIB
S3_CCTCAGTAGAACTCGG	APOE+ FIB
S3_TTCCCAGAGATGTAAC	Inflam. FIB
S3_CGATGTAGTGTCGCTG	APOE+ FIB
S3_CCGTGGAGTCCGAAGA	APOE+ FIB
S3_CTCGAAATCAGCTCTC	APOE+ FIB
S3_TTTATGCTCTTGAGAC	APOE+ FIB
S3_GACTAACTCCAAAGTC	APOE+ FIB
S3_GCATGATCAATCCGAT	APOE+ FIB
S3_GAATAAGAGTGTACCT	APOE+ FIB
S3_ATGAGGGAGACACGAC	APOE+ FIB
S3_CGAACATAGTGGTCCC	APOE+ FIB
S3_TGAGCCGAGGTGATAT	APOE+ FIB
S3_CTCATTATCGGATGGA	COL11A1+ FIB
S3_TCATTTGCAAAGTCAA	FBN1+ FIB
S3_ATTGGTGGTTGTTTGG	FBN1+ FIB
S3_CAGATCACAGTATGCT	APOE+ FIB
S3_TTCGGTCCATACTCTT	APOE+ FIB
S3_CACTCCAAGAACAATC	APOE+ FIB
S3_CGTCAGGCAGGAATCG	FBN1+ FIB
S3_TGCGTGGTCTTCATGT	APOE+ FIB
S3_CATATGGTCCAGATCA	APOE+ FIB
S3_TACAGTGCAAGAAGAG	APOE+ FIB
S3_TGAGCATAGATTACCC	COL11A1+ FIB
S3_TACCTTACATGGGAAC	FBN1+ FIB
S3_GGACAAGTCGTCTGAA	FBN1+ FIB
S3_CTCTGGTTCACATGCA	FBN1+ FIB
S3_CCGGGATAGCCAGGAT	APOE+ FIB
S3_GTATCTTAGGGTCTCC	APOE+ FIB
S3_TGAGGGAAGTGAACAT	APOE+ FIB
S3_CGAGAAGTCCAAACAC	COL11A1+ FIB
S3_ATTGGTGTCAACGCTA	APOE+ FIB
S3_CAACCTCCACCGAATT	APOE+ FIB
S3_CTCACACTCCTATGTT	APOE+ FIB
S3_GTATTCTTCCCGACTT	APOE+ FIB
S3_GACGCGTCAACTGGCC	APOE+ FIB
S3_TAGGCATTCGCAAGCC	APOE+ FIB
S3_ACATACGTCTGTACGA	APOE+ FIB
S3_AACCATGTCGCATGGC	APOE+ FIB
S3_ACATGGTGTCCCTACT	COL11A1+ FIB
S3_TACACGATCGCTTAGA	APOE+ FIB
S3_ATGGGAGAGCAACGGT	FBN1+ FIB
S3_ATCATGGTCTTGCAAG	APOE+ FIB
S3_GAAGCAGAGTCCAGGA	APOE+ FIB
S3_ATTATCCCAGTAAGAT	APOE+ FIB
S3_CATATTCCAATCTGCA	APOE+ FIB
S3_CTACCCATCAGCTGGC	FBN1+ FIB
S3_TCACAAGAGACTTGAA	COL11A1+ FIB
S3_AGCATACTCCTTGGTC	APOE+ FIB
S3_GACTACACAAGTTCTG	APOE+ FIB
S3_TGGGAAGGTTAAGGGC	FBN1+ FIB
S3_TGGCGCACACTGTGTA	APOE+ FIB
S3_AGACGTTAGTGTCTCA	APOE+ FIB
S3_CTACGTCTCTTGAGAC	COL11A1+ FIB
S3_ATCCACCAGGCTCATT	FBN1+ FIB
S3_ATAACGCAGGAATCGC	APOE+ FIB
S3_AGCATACCACATCCAA	APOE+ FIB
S3_GACAGAGAGGGAAACA	APOE+ FIB
S3_GGGCACTTCTATCGCC	APOE+ FIB
S3_CGGACACTCGTCTGCT	APOE+ FIB
S3_GACGTTACACGAAACG	FBN1+ FIB
S3_TTGGAACGTGGTCTCG	APOE+ FIB
S3_GGCAATTCACCACGTG	FBN1+ FIB
S3_ACGGGCTGTTAGGGTG	APOE+ FIB
S3_CGTGTCTGTGGCAAAC	APOE+ FIB
S3_TACAGTGAGTCAAGGC	APOE+ FIB
S3_ACTGCTCGTAGTACCT	APOE+ FIB
S3_AAACGGGCAGTCCTTC	COL11A1+ FIB
S3_GAGGTGACAAGTCATC	APOE+ FIB
S3_AACCATGCATACGCTA	COL11A1+ FIB
S3_CTTTGCGTCAGATAAG	APOE+ FIB
S3_ACTGAACTCCAGAGGA	APOE+ FIB
S3_TACGGTAGTACCGGCT	APOE+ FIB
S3_GTTCGGGAGTGTGGCA	FBN1+ FIB
S3_CTCTAATCAATAGCGG	APOE+ FIB
S3_CTCGAGGTCGGCGCAT	APOE+ FIB
S3_TGACGGCAGACAGAGA	APOE+ FIB
S3_CTCGGGATCAGGCGAA	APOE+ FIB
S3_TTGGAACCACGTAAGG	APOE+ FIB
S3_ATGCGATCATCCAACA	APOE+ FIB
S3_CTACCCAAGAATAGGG	APOE+ FIB
S3_GACGCGTCAGATGGCA	Inflam. FIB
S3_TCAGATGCATTCCTCG	APOE+ FIB
S3_GTCTCGTGTGTTTGTG	APOE+ FIB
S3_TATCAGGGTTGTACAC	APOE+ FIB
S3_CTGATAGCACCGTTGG	APOE+ FIB
S3_GGACATTCAGCTGTTA	APOE+ FIB
S3_TACAGTGTCCTTTCGG	APOE+ FIB
S3_CGCCAAGGTGAAATCA	APOE+ FIB
S3_TAAGAGAAGGCGATAC	APOE+ FIB
S3_CCGTACTTCAACTCTT	APOE+ FIB
S3_ATCCACCCATTAGGCT	COL11A1+ FIB
S3_TGGACGCTCCACGAAT	APOE+ FIB
S3_ATTCTACCATAGACTC	APOE+ FIB
S3_ACCTTTATCGTCTGAA	APOE+ FIB
S3_CCTTCGAAGACACTAA	APOE+ FIB
S3_AAATGCCAGACGACGT	APOE+ FIB
S3_ATCTACTAGTGTTGAA	APOE+ FIB
S3_TCGGTAACATTGGTAC	APOE+ FIB
S3_ACCCACTAGCGCCTCA	APOE+ FIB
S3_CACATTTTCAGGTTCA	COL11A1+ FIB
S3_CGCTGGAAGATACACA	APOE+ FIB
S3_ATCTGCCCACCACGTG	APOE+ FIB
S3_CTAACTTCATTCTTAC	APOE+ FIB
S3_ACTGTCCTCACATAGC	FBN1+ FIB
S3_CAAGAAAGTTCGCTAA	APOE+ FIB
S3_AGAATAGCAATCTGCA	APOE+ FIB
S3_GCGGGTTGTTCCATGA	APOE+ FIB
S3_ACGCCAGTCTTCCTTC	APOE+ FIB
S3_CAGCATACAATGGATA	COL11A1+ FIB
S3_TAAGCGTCACGCCAGT	APOE+ FIB
S3_TTCGGTCGTTGGGACA	APOE+ FIB
S3_CGATTGAAGATAGGAG	APOE+ FIB
S3_GCTGCGAAGTTTCCTT	APOE+ FIB
S3_ACACCCTCAAGTCTGT	APOE+ FIB
S3_CCGGGATCACTTCGAA	FBN1+ FIB
S3_AGCTCCTCATACTCTT	FBN1+ FIB
S3_TTGCCGTAGGTACTCT	APOE+ FIB
S3_GGAATAAAGGGTGTGT	FBN1+ FIB
S3_AAGACCTGTTGTACAC	APOE+ FIB
S3_ACACCCTAGACTCGGA	APOE+ FIB
S3_TTCTTAGAGGAATGGA	APOE+ FIB
S3_ACTGAACGTGGTCTCG	FBN1+ FIB
S3_GCGCAGTGTGCGATAG	APOE+ FIB
S3_GCGACCATCCTGCTTG	APOE+ FIB
S3_TAAGCGTCAGCCAGAA	APOE+ FIB
S3_CAGCTGGTCGGTTCGG	COL11A1+ FIB
S3_CATCAGAGTCCCTACT	FBN1+ FIB
S3_GACTGCGCATGCAATC	APOE+ FIB
S3_AAATGCCCAAACCCAT	APOE+ FIB
S3_CCTTACGGTGATGATA	FBN1+ FIB
S3_ACTGAGTAGGGTCGAT	APOE+ FIB
S3_CTCATTACAATGGTCT	APOE+ FIB
S3_GAACGGACATCTCGCT	APOE+ FIB
S3_GGCGACTGTTATGCGT	APOE+ FIB
S3_TTAGGACTCGGCGCTA	APOE+ FIB
S3_AACCATGCATTCACTT	APOE+ FIB
S3_GCGGGTTCATGTAGTC	COL11A1+ FIB
S3_GGGACCTCATTCCTGC	APOE+ FIB
S3_TTAGGACCACGAAGCA	APOE+ FIB
S3_ACTGTCCTCCAACCAA	APOE+ FIB
S3_CAACTAGCACCCAGTG	APOE+ FIB
S3_GATCGCGCAGACAGGT	FBN1+ FIB
S3_CCAGCGAGTATATCCG	APOE+ FIB
S3_CGATGGCCAACTTGAC	APOE+ FIB
S3_TCGGTAAGTAGCCTCG	APOE+ FIB
S3_TACACGATCGTTACAG	APOE+ FIB
S3_CCAATCCAGCTAGGCA	APOE+ FIB
S3_CTAATGGTCGTCTGAA	COL11A1+ FIB
S3_CACATTTGTTACGTCA	FBN1+ FIB
S3_CCTTACGCAGCCAATT	FBN1+ FIB
S3_CTTAGGAAGAAAGTGG	APOE+ FIB
S3_CACAAACGTGCGCTTG	APOE+ FIB
S3_CTAGAGTCACAGACAG	FBN1+ FIB
S3_CGACTTCTCCAAACTG	COL11A1+ FIB
S3_GCTGCGAGTAAGAGAG	APOE+ FIB
S3_GCATGATAGCAGGCTA	FBN1+ FIB
S3_CGCTATCCAGGTGGAT	APOE+ FIB
S3_CCATGTCCATTACGAC	Inflam. FIB
S3_TACCTATCATCCGCGA	APOE+ FIB
S3_ACACCAAAGTCTCGGC	APOE+ FIB
S3_GACTACACATTTGCCC	APOE+ FIB
S3_CATGGCGCAGACAAAT	Inflam. FIB
S3_CGTTGGGAGGCTAGAC	APOE+ FIB
S3_CCATTCGAGCGATAGC	APOE+ FIB
S3_AATCCAGTCTCCTATA	APOE+ FIB
S3_TGTGTTTAGCGACGTA	COL11A1+ FIB
S3_CCCTCCTCATGATCCA	APOE+ FIB
S3_TTTGCGCGTTGTTTGG	APOE+ FIB
S3_CACAGGCGTGTATGGG	COL11A1+ FIB
S3_TAGCCGGGTAAGGGCT	APOE+ FIB
S3_CCGTACTCACGACTCG	FBN1+ FIB
S3_CAAGGCCTCACCGGGT	APOE+ FIB
S3_ATCCACCCACACCGAC	APOE+ FIB
S3_AAGGTTCCATCGATGT	APOE+ FIB
S3_GACGGCTGTGAGTGAC	APOE+ FIB
S3_ACACCAATCTGAAAGA	FBN1+ FIB
S3_AACTTTCAGGAATGGA	FBN1+ FIB
S3_CTACATTGTGTAAGTA	APOE+ FIB
S3_AGTCTTTTCACTGGGC	FBN1+ FIB
S3_TAAGTGCCAATGGAGC	COL11A1+ FIB
S3_CCACCTACAGATGAGC	COL11A1+ FIB
S3_TAGACCAAGATACACA	APOE+ FIB
S3_CGCGGTAAGCAGGTCA	APOE+ FIB
S3_CGTTGGGAGTCGTACT	APOE+ FIB
S3_CGATGGCTCATCGATG	APOE+ FIB
S3_GTAACTGGTACTTGAC	APOE+ FIB
S3_TGCGCAGCAGATCGGA	COL11A1+ FIB
S3_GCATGATAGGGATCTG	APOE+ FIB
S3_GCACATAAGAGATGAG	APOE+ FIB
S3_TGGTTAGTCAGAGGTG	APOE+ FIB
S3_CCTCTGAAGTGGAGAA	APOE+ FIB
S3_CGACTTCAGGAATGGA	APOE+ FIB
S3_CTCTACGGTCGCGGTT	FBN1+ FIB
S3_GATGCTAAGGCAATTA	COL11A1+ FIB
S3_CGGCTAGGTTATCGGT	APOE+ FIB
S3_TGCGCAGAGACAGACC	FBN1+ FIB
S3_TCAGCAAGTCTCACCT	FBN1+ FIB
S3_GGGTTGCAGGTGCTAG	APOE+ FIB
S3_CTTAGGACACGACGAA	APOE+ FIB
S3_GTATTCTTCCAAAGTC	FBN1+ FIB
S3_ACGTCAAAGAGGTTGC	APOE+ FIB
S3_ATGGGAGGTGACTCAT	APOE+ FIB
S3_CCCATACAGACAGGCT	APOE+ FIB
S3_CTCAGAATCTAACTTC	APOE+ FIB
S3_GAACCTACAAGAAGAG	APOE+ FIB
S3_CTCGTACAGAAACGCC	APOE+ FIB
S3_CAGTAACGTTCGTCTC	APOE+ FIB
S3_ACATACGTCACGAAGG	APOE+ FIB
S3_GGCGTGTTCTCCGGTT	APOE+ FIB
S3_CGGACTGAGGATGGTC	Inflam. FIB
S3_ACTGTCCCAAGCTGAG	APOE+ FIB
S3_AGTTGGTTCAGCTGGC	APOE+ FIB
S3_CAGGTGCGTCTAGTGT	FBN1+ FIB
S3_AGTGTCATCCCAACGG	APOE+ FIB
S3_TGACTAGGTAAAGGAG	FBN1+ FIB
S3_GGAAAGCAGATGCCAG	APOE+ FIB
S3_GCCTCTAGTGCCTGCA	APOE+ FIB
S3_CGTCCATAGTTCGCGC	APOE+ FIB
S3_ATCCACCTCTACGAGT	FBN1+ FIB
S3_CACACTCTCCGTACAA	FBN1+ FIB
S3_GACAGAGGTGCAACGA	FBN1+ FIB
S3_ACCCACTGTCACCTAA	COL11A1+ FIB
S3_CGCGTTTCACAGGTTT	FBN1+ FIB
S3_GCGCCAAGTCGAATCT	APOE+ FIB
S3_CAGTCCTTCAAGGTAA	APOE+ FIB
S3_CCGGGATCACGGCTAC	Inflam. FIB
S3_GTCAAGTGTGGCGAAT	APOE+ FIB
S3_GTCATTTTCTGTCTAT	APOE+ FIB
S3_TAAGTGCCAAATACAG	FBN1+ FIB
S3_GACTACAGTCGTTGTA	APOE+ FIB
S3_CAAGTTGTCTCAAGTG	APOE+ FIB
S3_CTCGTACAGTCCATAC	APOE+ FIB
S3_AGGGTGACACGAAACG	COL11A1+ FIB
S3_CCGTTCATCGGTCCGA	APOE+ FIB
S3_GCAAACTTCATACGGT	APOE+ FIB
S3_GGTGTTACAAGTAGTA	APOE+ FIB
S3_TGACTTTTCAGTCAGT	APOE+ FIB
S3_AAGTCTGTCGTATCAG	FBN1+ FIB
S3_AGGCCACTCAACGAAA	Inflam. FIB
S3_CACAAACTCGGAAACG	FBN1+ FIB
S3_ACTTACTAGGCCCTTG	FBN1+ FIB
S3_GTCAAGTAGGATGGAA	Inflam. FIB
S3_GAAGCAGAGTGAACGC	APOE+ FIB
S3_AAACCTGTCAACTCTT	FBN1+ FIB
S3_CGATGTAGTGTTTGGT	APOE+ FIB
S3_CTTGGCTTCCGCAGTG	FBN1+ FIB
S3_GTTTCTACACGAAATA	APOE+ FIB
S3_GAACATCGTGTTTGTG	COL11A1+ FIB
S3_TCTCATACAGCTGCAC	APOE+ FIB
S3_CGTTGGGGTAGCCTCG	COL11A1+ FIB
S3_CAAGGCCCAACACGCC	APOE+ FIB
S3_GAATGAACACCGTTGG	APOE+ FIB
S3_AACTGGTAGCCTCGTG	FBN1+ FIB
S3_TCATTTGGTGCTAGCC	APOE+ FIB
S3_GTCTCGTAGCTAGCCC	APOE+ FIB
S3_TAGAGCTAGTTTAGGA	APOE+ FIB
S3_CTGATAGGTATCTGCA	APOE+ FIB
S3_CAGCAGCTCGCGTTTC	APOE+ FIB
S3_CATCCACGTCTTGCGG	APOE+ FIB
S3_CATCCACCAGAGCCAA	APOE+ FIB
S3_CGTTAGACATTGCGGC	COL11A1+ FIB
S3_GCACATAGTGCGAAAC	APOE+ FIB
S3_CGTCTACGTCTAGTGT	APOE+ FIB
S3_GAACGGATCTTACCGC	APOE+ FIB
S3_CTAGTGAAGGTCATCT	FBN1+ FIB
S3_CCGTTCATCATTTGGG	COL11A1+ FIB
S3_ACGCCAGAGGGAAACA	APOE+ FIB
S3_CGCGTTTAGAGCTGCA	APOE+ FIB
S3_CACAGTACACTCAGGC	APOE+ FIB
S3_GCCAAATTCTCTTATG	APOE+ FIB
S3_CACACCTAGACACGAC	APOE+ FIB
S3_CGGCTAGCACAAGACG	FBN1+ FIB
S3_ATCATCTAGTCAAGCG	APOE+ FIB
S3_GTTAAGCCAGACAAGC	APOE+ FIB
S3_TTGTAGGCACATGACT	APOE+ FIB
S3_TCGCGAGGTGACGGTA	FBN1+ FIB
S3_TGCGGGTGTTCACGGC	APOE+ FIB
S3_CTCGGGAAGAAGGGTA	APOE+ FIB
S3_GTACGTAGTGCAACTT	APOE+ FIB
S3_CTCGGGACACAGCCCA	APOE+ FIB
S3_CGTAGCGAGTACTTGC	FBN1+ FIB
S3_TGATTTCTCGGAGCAA	APOE+ FIB
S3_CGGAGTCTCGTTGACA	APOE+ FIB
S3_CACATAGTCCCATTAT	APOE+ FIB
S3_CGAACATCAGAAGCAC	APOE+ FIB
S3_CTAACTTTCCCATTAT	APOE+ FIB
S3_TGAGCCGGTTCCATGA	COL11A1+ FIB
S3_ACTTGTTCAGTCCTTC	APOE+ FIB
S3_CTGGTCTTCGGCCGAT	APOE+ FIB
S3_TACGGATCAATGAAAC	APOE+ FIB
S3_CGGCTAGTCACTTCAT	APOE+ FIB
S3_TCAACGAAGATCGATA	APOE+ FIB
S3_CACACCTAGGGATGGG	COL11A1+ FIB
S3_AACCGCGGTCATCGGC	APOE+ FIB
S3_GCACTCTGTTCAGCGC	FBN1+ FIB
S3_GCGAGAATCCGCGTTT	FBN1+ FIB
S3_CTCGAGGTCTATCCTA	FBN1+ FIB
S3_ACGCAGCCAGGATTGG	FBN1+ FIB
S3_GCAGTTATCCCAAGTA	APOE+ FIB
S3_GCAAACTGTCGGCATC	APOE+ FIB
S3_CATTATCGTTAGGGTG	APOE+ FIB
S3_TCTCTAAAGACTACAA	COL11A1+ FIB
S3_CGATTGATCGTTGACA	FBN1+ FIB
S3_ACTGAGTCAAATCCGT	Inflam. FIB
S3_ACTTGTTTCTAGCACA	APOE+ FIB
S3_ATCGAGTCACTATCTT	APOE+ FIB
S3_CACCACTGTAGCTTGT	APOE+ FIB
S3_CATATTCGTGACGGTA	APOE+ FIB
S3_TGTATTCTCCATTCTA	APOE+ FIB
S3_CCACGGAAGAGTTGGC	APOE+ FIB
S3_ATTATCCGTTCTGAAC	APOE+ FIB
S3_CCTTTCTCATGGGAAC	APOE+ FIB
S3_CGTTCTGTCTTGTATC	APOE+ FIB
S3_CATCCACTCTTGGGTA	APOE+ FIB
S3_AACTTTCGTGATAAGT	FBN1+ FIB
S3_AGCTCTCAGGGAGTAA	APOE+ FIB
S3_CGGTTAAAGCGATAGC	APOE+ FIB
S3_TACCTTAAGGCAAAGA	APOE+ FIB
S3_ACGCCAGGTGTCTGAT	COL11A1+ FIB
S3_GGCCGATTCTTGTTTG	APOE+ FIB
S3_TACGGGCTCCTTGGTC	FBN1+ FIB
S3_GTTAAGCCATTAGGCT	APOE+ FIB
S3_GATGAAAGTAGAAGGA	APOE+ FIB
S3_GTGCTTCAGCTACCGC	FBN1+ FIB
S3_TGCGTGGAGATCTGCT	APOE+ FIB
S3_CAGATCACATGACATC	APOE+ FIB
S3_GATCGTATCAGCATGT	FBN1+ FIB
S3_ATCTACTTCCCACTTG	Inflam. FIB
S3_CGAACATCATTGAGCT	APOE+ FIB
S3_ACTGCTCAGCAACGGT	APOE+ FIB
S3_ATTACTCAGCAATCTC	FBN1+ FIB
S3_GCATACATCACATACG	APOE+ FIB
S3_GTGGGTCGTCAAAGAT	APOE+ FIB
S3_AGGGATGGTAGAGTGC	APOE+ FIB
S3_GGCAATTTCTGCCCTA	APOE+ FIB
S3_CATCAAGTCACATGCA	COL11A1+ FIB
S3_CTAAGACGTAAATGTG	Inflam. FIB
S3_ACGCCAGGTACCGGCT	FBN1+ FIB
S3_CGTGTAATCCCAAGAT	APOE+ FIB
S3_CCTAAAGGTTATCCGA	APOE+ FIB
S3_GGCGTGTAGTGAAGAG	FBN1+ FIB
S3_AAAGCAAGTTTGTTTC	FBN1+ FIB
S3_AGCTCCTAGGCTATCT	COL11A1+ FIB
S3_CCATGTCTCACTTATC	APOE+ FIB
S3_CATCCACGTTACGGAG	APOE+ FIB
S3_GATCAGTTCTATGTGG	FBN1+ FIB
S3_AGAGTGGTCTATCGCC	COL11A1+ FIB
S3_CTGCTGTCATTGGGCC	APOE+ FIB
S3_ACATGGTGTTCCGGCA	APOE+ FIB
S3_TCACAAGCACACTGCG	APOE+ FIB
S3_ACACTGACACAGGTTT	APOE+ FIB
S3_GTACTTTTCGCTGATA	APOE+ FIB
S3_CTCTACGTCTGAGGGA	APOE+ FIB
S3_TATGCCCCATGACATC	APOE+ FIB
S3_TGCTGCTGTGCACTTA	APOE+ FIB
S3_GACAGAGTCTTGCAAG	APOE+ FIB
S3_GTCACGGTCGGCGCAT	APOE+ FIB
S3_CTAACTTCAGGCAGTA	APOE+ FIB
S3_ACTGTCCTCGTCGTTC	APOE+ FIB
S3_AGCCTAAAGCGGCTTC	APOE+ FIB
S3_ATCGAGTAGTGGACGT	FBN1+ FIB
S3_GTGCAGCCACTAAGTC	APOE+ FIB
S3_GATCGTAGTGTGCGTC	APOE+ FIB
S3_CTCTACGGTCGTGGCT	FBN1+ FIB
S3_GCATACACATCATCCC	APOE+ FIB
S3_GCGCAGTAGTAGCCGA	APOE+ FIB
S3_ACTTGTTTCGACCAGC	FBN1+ FIB
S3_GGGAATGCACCAGGTC	FBN1+ FIB
S3_GTTCATTAGTCCTCCT	APOE+ FIB
S3_TGAAAGAGTCGCTTCT	APOE+ FIB
S3_ACGGCCACACTTGGAT	COL11A1+ FIB
S3_AGAGCGACAACGATCT	APOE+ FIB
S3_TGACTTTTCATGTCCC	APOE+ FIB
S3_AAGGTTCTCTGTACGA	Inflam. FIB
S3_CTCGAGGCATACTACG	FBN1+ FIB
S3_AACCGCGAGCGGATCA	FBN1+ FIB
S3_CTCCTAGGTGAAAGAG	APOE+ FIB
S3_TTAGGACCAGGCTGAA	APOE+ FIB
S3_GACTAACTCTAGAGTC	FBN1+ FIB
S3_CGGACTGGTTCATGGT	APOE+ FIB
S3_GTACTTTAGAGAACAG	APOE+ FIB
S3_TTGGCAAGTCTTTCAT	APOE+ FIB
S3_CAGCTGGGTCGAGATG	APOE+ FIB
S3_TAGTGGTTCTTGCAAG	APOE+ FIB
S3_AGGGTGATCCATGCTC	APOE+ FIB
S3_AGCGTCGGTCAATACC	APOE+ FIB
S3_TGACTAGCACCATCCT	FBN1+ FIB
S3_ACGCCGATCGTTACGA	COL11A1+ FIB
S3_GTCCTCAAGCTGTCTA	FBN1+ FIB
S3_TGTGTTTCACGAGGTA	APOE+ FIB
S3_TCATTACAGATTACCC	APOE+ FIB
S3_TGACTTTCAGTCGTGC	APOE+ FIB
S3_GCAGTTAAGACAGAGA	COL11A1+ FIB
S3_TACGGTAAGACTAGGC	APOE+ FIB
S3_CATGGCGCAGTCGTGC	FBN1+ FIB
S3_TCAGGATCAAACAACA	APOE+ FIB
S3_GGACAAGAGATCTGAA	APOE+ FIB
S3_ACGGGCTGTTCAGACT	Inflam. FIB
S3_ATCCGAATCCATGAAC	APOE+ FIB
S3_GGCAATTCATTTGCCC	COL11A1+ FIB
S3_CGTCTACAGCCACGCT	APOE+ FIB
S3_ATAGACCGTCTAGAGG	FBN1+ FIB
S3_CACACCTAGCCACGCT	FBN1+ FIB
S3_ACGAGCCAGGACCACA	APOE+ FIB
S3_CACTCCACATACAGCT	APOE+ FIB
S3_CTGCGGAGTCAAGCGA	APOE+ FIB
S3_TTCTCAAAGAAACCAT	APOE+ FIB
S3_ACAGCTACACCATGTA	COL11A1+ FIB
S3_GCTCTGTTCCCTCAGT	APOE+ FIB
S3_CTTCTCTCACGAAGCA	FBN1+ FIB
S3_TTAGGCATCAACTCTT	APOE+ FIB
S3_CTACGTCGTGTTTGTG	APOE+ FIB
S3_CTCGTACTCGTTACGA	APOE+ FIB
S3_CTCGTCACATATACCG	APOE+ FIB
S3_GCTGCGAGTGCAACTT	APOE+ FIB
S3_ACCCACTTCTGTTGAG	APOE+ FIB
S3_TGGACGCAGAGTACAT	APOE+ FIB
S3_GAATGAATCAGCTCTC	APOE+ FIB
S3_TGACGGCTCACTCCTG	APOE+ FIB
S3_CACACTCAGAACTGTA	APOE+ FIB
S3_GATCTAGGTGGTCCGT	APOE+ FIB
S3_TGCCCATCATCGGACC	APOE+ FIB
S3_ACGGGCTCAAATACAG	APOE+ FIB
S3_TACCTTAAGACCACGA	COL11A1+ FIB
S3_CGTCAGGCATCAGTCA	FBN1+ FIB
S3_GGACAGAAGGTGGGTT	FBN1+ FIB
S3_AGTTGGTTCTTGACGA	APOE+ FIB
S3_TCTGGAATCCTAGGGC	APOE+ FIB
S3_TCTTCGGCACATTTCT	APOE+ FIB
S3_CCTTCGAGTATAGGGC	APOE+ FIB
S3_AGTTGGTGTCAGTGGA	FBN1+ FIB
S3_AACCATGTCGTAGATC	APOE+ FIB
S3_GTAACTGCATGGTAGG	APOE+ FIB
S3_GTAACGTTCCTTGACC	APOE+ FIB
S3_CGGAGTCGTAGGCTGA	APOE+ FIB
S3_CTACACCCATTCTTAC	APOE+ FIB
S3_ACGCAGCCAGGAATGC	APOE+ FIB
S3_AACGTTGAGACACGAC	FBN1+ FIB
S3_GATTCAGGTCCGACGT	APOE+ FIB
S3_ATCCACCCAGCAGTTT	APOE+ FIB
S3_GTCACAAGTATCGCAT	COL11A1+ FIB
S3_ATCTACTTCAACGCTA	APOE+ FIB
S3_CTAACTTTCTGACCTC	APOE+ FIB
S3_CGCGGTATCACCAGGC	APOE+ FIB
S3_TGAGGGAAGGCGACAT	APOE+ FIB
S3_TTTGTCACACAACGTT	APOE+ FIB
S3_GCAAACTCACGACGAA	Inflam. FIB
S3_CTCTACGCACCCATGG	APOE+ FIB
S3_CCAGCGACAGATCCAT	COL11A1+ FIB
S3_GTGGGTCGTCTCTTAT	APOE+ FIB
S3_GGGACCTGTGTTTGTG	Inflam. FIB
S3_ACTGATGTCACTGGGC	APOE+ FIB
S3_CTCAGAACATGTCCTC	APOE+ FIB
S3_CTCGTACTCTGATACG	APOE+ FIB
S3_TCGAGGCTCACGCGGT	FBN1+ FIB
S3_ACGTCAAGTCGCGAAA	APOE+ FIB
S3_GGGATGAAGTTTGCGT	FBN1+ FIB
S3_CCAATCCTCCACGACG	APOE+ FIB
S3_CAAGAAACAATACGCT	APOE+ FIB
S3_CCGTGGATCATGCAAC	APOE+ FIB
S3_CCTACCAAGATCGATA	FBN1+ FIB
S3_TATGCCCTCTGACCTC	APOE+ FIB
S3_GTGCAGCCACAACGTT	FBN1+ FIB
S3_TTCGGTCAGCTATGCT	APOE+ FIB
S3_TTTGGTTGTCAGCTAT	APOE+ FIB
S3_AACTGGTTCTGACCTC	APOE+ FIB
S3_ATTTCTGTCTTCAACT	APOE+ FIB
S3_TACCTATAGTTCGATC	APOE+ FIB
S3_TGACGGCCACGTCAGC	APOE+ FIB
S3_GATGAAACAAAGGCGT	APOE+ FIB
S3_ATGCGATCAAACGCGA	COL11A1+ FIB
S3_TCTCTAAAGACGACGT	FBN1+ FIB
S3_CGTAGCGTCTAACTGG	APOE+ FIB
S3_CTACGTCGTCTCTTTA	APOE+ FIB
S3_GCTTGAAAGAGCCCAA	APOE+ FIB
S3_TTGAACGTCGGTTAAC	FBN1+ FIB
S3_ACGCCGAGTGCCTTGG	APOE+ FIB
S3_GCACTCTTCTGGAGCC	APOE+ FIB
S3_CACATAGCATTAACCG	APOE+ FIB
S3_TTGGAACTCTGGAGCC	APOE+ FIB
S3_GGCGACTAGCCTATGT	APOE+ FIB
S3_GGCGTGTTCTGTCTAT	APOE+ FIB
S3_CGTGTCTCAATCGGTT	FBN1+ FIB
S3_AGTGAGGGTCTCTCTG	APOE+ FIB
S3_GTCATTTCATCGGGTC	APOE+ FIB
S3_TGCTGCTCACCACCAG	APOE+ FIB
S3_GTGCGGTTCGGAGCAA	APOE+ FIB
S3_TCAGCAATCTTGTACT	COL11A1+ FIB
S3_GTAACGTTCCAATGGT	APOE+ FIB
S3_ATTATCCAGAGATGAG	FBN1+ FIB
S3_TTCTACAGTCAGATAA	FBN1+ FIB
S3_CTCATTACACAGATTC	APOE+ FIB
S3_CCACTACCAAGTCTAC	APOE+ FIB
S3_TGACAACCAGGCAGTA	Inflam. FIB
S3_GGTGTTAAGGATGCGT	APOE+ FIB
S3_TACCTTATCTCTTGAT	APOE+ FIB
S3_AGCTCTCGTTTGTTTC	APOE+ FIB
S3_ACGGAGAAGCTAACAA	APOE+ FIB
S3_AAGGTTCGTATTACCG	APOE+ FIB
S3_CGGACGTTCCTTGACC	APOE+ FIB
S3_ACGCCAGCAACACCCG	APOE+ FIB
S3_AAGACCTAGGCTATCT	APOE+ FIB
S3_TACGGTATCGGTCCGA	APOE+ FIB
S3_CTACACCTCCTTGGTC	APOE+ FIB
S3_GCGCAACGTAGAAGGA	APOE+ FIB
S3_TAAGCGTAGATATACG	APOE+ FIB
S3_CAAGGCCAGACTCGGA	APOE+ FIB
S3_GCTGGGTTCCGTTGTC	APOE+ FIB
S3_AGGGATGAGGTCGGAT	APOE+ FIB
S3_TTATGCTAGACACGAC	COL11A1+ FIB
S3_GCGACCAGTTGGTTTG	APOE+ FIB
S3_GGACGTCTCGTGACAT	APOE+ FIB
S3_CGTTAGAGTTCCGTCT	APOE+ FIB
S3_GACGCGTCATCACGTA	COL11A1+ FIB
S3_TCAGGATAGTACGCCC	APOE+ FIB
S3_TGAGCCGTCTGCGGCA	APOE+ FIB
S3_GATCGTACAAGCGTAG	APOE+ FIB
S3_TGTCCCAAGATCCGAG	APOE+ FIB
S3_CGTTGGGGTCCATGAT	FBN1+ FIB
S3_GGAACTTTCACTCTTA	APOE+ FIB
S3_CGTAGGCAGTTAACGA	APOE+ FIB
S3_CTCGAGGCACAGGTTT	APOE+ FIB
S3_CTTTGCGGTGGTTTCA	APOE+ FIB
S3_TAAGTGCAGTGACTCT	APOE+ FIB
S3_TCCCGATGTCGCGAAA	APOE+ FIB
S3_CGCGGTACAAGCCTAT	APOE+ FIB
S3_CCAGCGAGTCCCTACT	APOE+ FIB
S3_CAGCTAAGTCAGATAA	APOE+ FIB
S3_GAAACTCGTTGGGACA	APOE+ FIB
S3_TTCTTAGGTACCTACA	APOE+ FIB
S3_GACCTGGTCTCTGCTG	APOE+ FIB
S3_ATCACGACAGGAACGT	APOE+ FIB
S3_GTTACAGAGTTAGGTA	FBN1+ FIB
S3_ATTCTACCACCAGCAC	COL11A1+ FIB
S3_CGGACTGCACAACGCC	APOE+ FIB
S3_CTCATTATCCACGTGG	APOE+ FIB
S3_GCATACACAGGACCCT	APOE+ FIB
S3_CTAGTGAAGGATGGAA	APOE+ FIB
S3_TCAGATGCAAGCTGAG	APOE+ FIB
S3_AACTCAGAGAGAGCTC	APOE+ FIB
S3_TGACTTTTCTGTTTGT	APOE+ FIB
S3_CTGGTCTCAGATGGGT	APOE+ FIB
S3_ATTGGACGTTACGGAG	APOE+ FIB
S3_CACATTTAGGCGTACA	APOE+ FIB
S3_GTACTCCCACGGCGTT	APOE+ FIB
S3_ACACCCTAGAGCTATA	Inflam. FIB
S3_GTCTCGTAGAGGTAGA	APOE+ FIB
S3_ACGATACTCTCGTTTA	FBN1+ FIB
S3_CTGATCCGTCTAGAGG	APOE+ FIB
S3_GAACATCCAATAACGA	APOE+ FIB
S3_AACACGTGTGAAAGAG	APOE+ FIB
S3_GTTCATTTCTTGAGAC	APOE+ FIB
S3_ACTGCTCTCTACTATC	APOE+ FIB
S3_AACACGTCAGGGTATG	FBN1+ FIB
S3_CGTCAGGGTACCATCA	APOE+ FIB
S3_GAACCTATCTCGGACG	APOE+ FIB
S3_AACTTTCGTCTTCGTC	APOE+ FIB
S3_GCATGTAGTAGGAGTC	APOE+ FIB
S3_CTTTGCGAGTAGGTGC	FBN1+ FIB
S3_CTACATTTCTGGTGTA	FBN1+ FIB
S3_CCCAGTTTCAACCAAC	APOE+ FIB
S3_GTAACGTAGGTGCTTT	APOE+ FIB
S3_TCACGAACAAAGTGCG	APOE+ FIB
S3_TTTGCGCTCAGAGCTT	APOE+ FIB
S3_ACATCAGCAAGGGTCA	APOE+ FIB
S3_GCAGTTATCTTAGCCC	FBN1+ FIB
S3_AAAGATGGTACAGCAG	APOE+ FIB
S3_GTTCGGGCACCGAATT	APOE+ FIB
S3_CATCGGGCATCCAACA	APOE+ FIB
S3_CTCACACAGTGACATA	FBN1+ FIB
S3_CAGATCACAAAGGAAG	FBN1+ FIB
S3_CGGACGTCATTGAGCT	APOE+ FIB
S3_GATCGATTCCTACAGA	APOE+ FIB
S3_CAAGTTGCATAGGATA	APOE+ FIB
S3_CATATTCCATGTTCCC	APOE+ FIB
S3_CATGCCTTCCTCGCAT	FBN1+ FIB
S3_GCTGCGACACTGTGTA	APOE+ FIB
S3_GAACATCTCTGCGACG	FBN1+ FIB
S3_GTAACTGAGAAACCTA	APOE+ FIB
S3_CATCAGATCGTAGATC	APOE+ FIB
S3_CTCGTCAGTCATGCCG	APOE+ FIB
S3_ACTGTCCAGAGCAATT	APOE+ FIB
S3_CCTCAGTGTAACGACG	APOE+ FIB
S3_ACCTTTACATGTTCCC	APOE+ FIB
S3_CTACATTGTTGTCGCG	APOE+ FIB
S3_TCTTTCCTCCTCTAGC	FBN1+ FIB
S3_GACTACATCAGTGCAT	APOE+ FIB
S3_CTCTACGTCCAAGTAC	APOE+ FIB
S3_TAGACCAAGGACGAAA	APOE+ FIB
S3_CCAATCCAGGACAGCT	APOE+ FIB
S3_AGGCCGTGTCATCGGC	Inflam. FIB
S3_TGTGGTAGTTTCGCTC	APOE+ FIB
S3_CGACTTCCACGCTTTC	FBN1+ FIB
S3_GGGATGAAGTGACTCT	FBN1+ FIB
S3_CAGAGAGCACGAGAGT	APOE+ FIB
S3_AGCTCTCGTCTAAACC	FBN1+ FIB
S3_TAGACCAAGCGTTCCG	APOE+ FIB
S3_AGTGAGGTCTTGCAAG	APOE+ FIB
S3_ACACCGGCAATGGAAT	FBN1+ FIB
S3_GGCTCGACACAGAGGT	APOE+ FIB
S3_GTCAAGTTCTGAGTGT	APOE+ FIB
S3_ATTCTACAGATCCCAT	APOE+ FIB
S3_TTTCCTCTCAGCTTAG	APOE+ FIB
S3_GTCGGGTTCGGTGTTA	APOE+ FIB
S3_CTGATCCCATTACGAC	APOE+ FIB
S3_ACTTGTTAGTGGAGTC	APOE+ FIB
S3_GCACATAGTGGCAAAC	APOE+ FIB
S3_TTGGAACTCGTAGGTT	APOE+ FIB
S3_CACCACTCAGATCCAT	APOE+ FIB
S3_GTAGGCCTCCTTGCCA	APOE+ FIB
S3_GTAGTCACACGGTTTA	APOE+ FIB
S3_TGATTTCGTTCCACTC	APOE+ FIB
S3_TTCTCAACAAAGTGCG	APOE+ FIB
S3_ATCATGGGTCGGCATC	APOE+ FIB
S3_TAAGTGCGTATCGCAT	APOE+ FIB
S3_CACATAGGTTCACGGC	APOE+ FIB
S3_TTCGAAGTCGCCTGAG	FBN1+ FIB
S3_ATCTGCCAGGATTCGG	FBN1+ FIB
S3_GTCATTTTCTAGCACA	APOE+ FIB
S3_TTGGCAAGTCAACTGT	FBN1+ FIB
S3_TATCAGGCAAATACAG	APOE+ FIB
S3_TCGGTAACAGCATGAG	FBN1+ FIB
S3_CCACGGAGTCCAACTA	APOE+ FIB
S3_ACCTTTATCAGTTCGA	COL11A1+ FIB
S3_CTGAAGTAGCTGAAAT	APOE+ FIB
S3_CCTTACGAGGACTGGT	APOE+ FIB
S3_ACTTTCAGTTCCACGG	FBN1+ FIB
S3_ATAAGAGGTACGACCC	APOE+ FIB
S3_AGTGGGACAACGCACC	APOE+ FIB
S3_CAGGTGCCAGCTGTAT	APOE+ FIB
S3_CTCTGGTGTGACGCCT	APOE+ FIB
S3_GACTGCGAGGCATGGT	APOE+ FIB
S3_TATCAGGGTTTCCACC	APOE+ FIB
S3_TAGAGCTAGGCGACAT	APOE+ FIB
S3_ATTATCCCAGATGGGT	APOE+ FIB
S3_TGTGTTTTCCAAACTG	Inflam. FIB
S3_ACGGCCAGTCACACGC	FBN1+ FIB
S3_TGACAACAGCCCGAAA	APOE+ FIB
S3_AAGGTTCGTCAGCTAT	APOE+ FIB
S3_AGAGTGGCAATGGAAT	FBN1+ FIB
S3_GTTCTCGCACAGTCGC	APOE+ FIB
S3_GCGCAGTAGAACTGTA	APOE+ FIB
S3_ATTCTACTCGTCACGG	APOE+ FIB
S3_TTGGAACCATATGCTG	APOE+ FIB
S3_TATCTCATCATCGATG	APOE+ FIB
S3_GATGCTATCATTATCC	APOE+ FIB
S3_TAGTGGTAGCTGCAAG	APOE+ FIB
S3_ACTTACTTCCACGAAT	APOE+ FIB
S3_CAAGATCGTGCAACGA	FBN1+ FIB
S3_CGAATGTCATCTGGTA	APOE+ FIB
S3_CGTTCTGAGGAATGGA	APOE+ FIB
S3_GGCCGATAGATCTGCT	APOE+ FIB
S3_ATGAGGGAGCGTAGTG	APOE+ FIB
S3_TTGCCGTCAACACGCC	APOE+ FIB
S3_CAGAGAGCAAACTGTC	APOE+ FIB
S3_GCGGGTTTCTTGAGAC	APOE+ FIB
S3_TTGGAACAGTGAACAT	APOE+ FIB
S3_ATTACTCAGAGCAATT	Inflam. FIB
S3_TACTTGTTCATGTCCC	APOE+ FIB
S3_GGAAAGCAGCTATGCT	APOE+ FIB
S3_GCGCGATAGAAGAAGC	APOE+ FIB
S3_GCAAACTAGCCACCTG	Inflam. FIB
S3_CTTAACTAGGACGAAA	FBN1+ FIB
S3_TAGAGCTCAGACGCCT	APOE+ FIB
S3_GACGCGTTCTACTTAC	COL11A1+ FIB
S3_GTCCTCAAGAAGATTC	FBN1+ FIB
S3_GTCATTTGTCGCGGTT	APOE+ FIB
S3_CACACTCCAAGTACCT	APOE+ FIB
S3_CTGAAGTCACGCTTTC	FBN1+ FIB
S3_TCAATCTTCTCTAGGA	FBN1+ FIB
S3_CATATTCTCAACGAAA	APOE+ FIB
S3_GCAAACTCATCGGACC	APOE+ FIB
S3_AGTGGGATCGGTGTTA	FBN1+ FIB
S3_ATCATGGGTATGCTTG	APOE+ FIB
S3_GTTCTCGGTGAACCTT	APOE+ FIB
S3_AGTGTCATCTTGTCAT	APOE+ FIB
S3_CGGAGTCGTCATGCAT	APOE+ FIB
S3_CGGACTGAGTAGATGT	APOE+ FIB
S3_GTCCTCAAGTGGAGTC	APOE+ FIB
S3_CAACCAACAGTCGATT	APOE+ FIB
S3_CTACATTCAGTTTACG	Inflam. FIB
S3_CACACCTAGAATGTGT	APOE+ FIB
S3_GCGACCAAGCTAAGAT	APOE+ FIB
S3_CTAGAGTGTGGACGAT	APOE+ FIB
S3_CAAGATCGTAGCGCTC	APOE+ FIB
S3_TACAGTGTCCAGTAGT	APOE+ FIB
S3_CACCACTGTCAGCTAT	APOE+ FIB
S3_ACACCCTGTCCAGTTA	APOE+ FIB
S3_GGCTGGTGTGTTTGTG	APOE+ FIB
S3_CGTGTAAAGATCACGG	APOE+ FIB
S3_TATTACCAGTGACATA	COL11A1+ FIB
S3_GGCCGATAGAAGCCCA	APOE+ FIB
S3_TGAAAGAAGAGACTAT	APOE+ FIB
S3_CTCATTATCACTGGGC	APOE+ FIB
S3_TACTCATAGAGCCCAA	APOE+ FIB
S3_AGGTCCGGTAGCGTCC	COL11A1+ FIB
S3_TTAACTCTCGACCAGC	APOE+ FIB
S3_TGTGGTACAAGCCCAC	APOE+ FIB
S3_GTGAAGGAGCTAGGCA	APOE+ FIB
S3_TTCTCAAGTATAGGTA	APOE+ FIB
S3_ACGGGTCTCTGGCGAC	APOE+ FIB
S3_GATCGTAAGATCTGAA	APOE+ FIB
S3_ACGCAGCCAGGACGTA	APOE+ FIB
S3_CGATTGAAGAGAGCTC	FBN1+ FIB
S3_CCAGCGACATGCTGGC	APOE+ FIB
S3_AAAGTAGCATCGGTTA	APOE+ FIB
S3_TGTATTCCAAGAGTCG	APOE+ FIB
S3_GCAATCAGTCTCCACT	COL11A1+ FIB
S3_ACGCCGAAGTGTCCCG	APOE+ FIB
S3_GCAATCAGTCTTGTCC	APOE+ FIB
S3_AGTGGGAAGTACACCT	APOE+ FIB
S3_GGCAATTGTGATGATA	COL11A1+ FIB
S3_TGGGCGTAGTGGTCCC	FBN1+ FIB
S3_TAGAGCTCACGTGAGA	APOE+ FIB
S3_CTAGAGTTCTCAAGTG	APOE+ FIB
S3_GCGCAGTAGCTCCTTC	APOE+ FIB
S3_AAACCTGGTGGTGTAG	APOE+ FIB
S3_AGAATAGGTAAGGGCT	APOE+ FIB
S3_CAAGTTGCAATGGAGC	APOE+ FIB
S3_ATAGACCAGTAGATGT	APOE+ FIB
S3_GCGGGTTTCAATCTCT	APOE+ FIB
S3_CGCTATCCAAATACAG	APOE+ FIB
S3_GGATTACAGCTGCGAA	COL11A1+ FIB
S3_GCTTCCATCTATGTGG	APOE+ FIB
S3_CAAGATCAGGGTCTCC	APOE+ FIB
S3_GTGCATATCTTGTACT	Inflam. FIB
S3_CGTCTACTCCCATTTA	APOE+ FIB
S3_CGTGTAACACGGACAA	APOE+ FIB
S3_CGTTCTGAGGCTAGAC	APOE+ FIB
S3_AACTCTTCATTACGAC	APOE+ FIB
S3_AGGCCGTTCAGTTTGG	APOE+ FIB
S3_CGACTTCTCGAATGGG	APOE+ FIB
S3_CTAGCCTGTCTGGAGA	APOE+ FIB
S3_GCAGTTATCGGTCTAA	COL11A1+ FIB
S3_TTATGCTGTGAGGGAG	APOE+ FIB
S3_CGACTTCCATACGCCG	COL11A1+ FIB
S3_CATCAAGCAGATTGCT	APOE+ FIB
S3_GGACGTCAGGGATACC	APOE+ FIB
S3_GTCCTCACACATAACC	APOE+ FIB
S3_CCAATCCTCCACGTTC	APOE+ FIB
S3_GTTAAGCCACCACGTG	APOE+ FIB
S3_TACGGATTCCGAACGC	APOE+ FIB
S3_GACTAACCATGGAATA	FBN1+ FIB
S3_CTTCTCTAGTGTTGAA	APOE+ FIB
S3_ATCACGACACGAAACG	APOE+ FIB
S3_CAACCTCAGCGATCCC	APOE+ FIB
S3_GGTATTGAGAGGTAGA	APOE+ FIB
S3_CGACTTCCAGGACCCT	FBN1+ FIB
S3_AAGCCGCGTCTAGTCA	APOE+ FIB
S3_GGACGTCAGCACGCCT	APOE+ FIB
S3_GCTGCTTCAAGCCGCT	APOE+ FIB
S3_CCTTCCCGTCCCTTGT	APOE+ FIB
S3_TATCAGGTCTATCCCG	APOE+ FIB
S3_CAAGTTGTCTTTAGGG	COL11A1+ FIB
S3_CGTCAGGGTGGACGAT	APOE+ FIB
S3_GCCTCTACAGACACTT	APOE+ FIB
S3_CGTAGCGTCCTAAGTG	APOE+ FIB
S3_TCCACACCAACTTGAC	FBN1+ FIB
S3_CTTAGGATCGAGCCCA	APOE+ FIB
S3_CCTATTAAGGCTATCT	APOE+ FIB
S3_ACGATACCAGACGTAG	APOE+ FIB
S3_GCAAACTTCTTGTACT	APOE+ FIB
S3_CATCGAAGTGCAGGTA	APOE+ FIB
S3_GTGTTAGCATAACCTG	APOE+ FIB
S3_GACACGCGTAAGTAGT	APOE+ FIB
S3_GTCTCGTTCGAACGGA	APOE+ FIB
S3_CTGATAGTCCTAGGGC	APOE+ FIB
S3_CTAGTGAAGAGACGAA	APOE+ FIB
S3_GGGAGATGTCATTAGC	APOE+ FIB
S3_CGACCTTCAATGAATG	APOE+ FIB
S3_TTGCGTCGTGTGGCTC	APOE+ FIB
S11_TTGGAACAGGTACTCT	APOE+ FIB
S11_ACATGGTCATCACGAT	FBN1+ FIB
S11_GTATTCTGTATATGGA	FBN1+ FIB
S11_AGCTCTCTCCGCAGTG	COL11A1+ FIB
S11_ACTGTCCTCGAATCCA	FBN1+ FIB
S11_GGCGACTAGCTACCGC	FBN1+ FIB
S11_ACTGTCCTCTTCAACT	FBN1+ FIB
S11_CATTATCAGGGAACGG	FBN1+ FIB
S11_TCGTACCTCCCGGATG	FBN1+ FIB
S11_TCGTAGACATATGAGA	FBN1+ FIB
S11_AACCGCGCATCGTCGG	COL11A1+ FIB
S11_AGAGCGATCATCACCC	COL11A1+ FIB
S11_TTAACTCTCCCTCTTT	FBN1+ FIB
S11_ATGCGATAGGGATGGG	COL11A1+ FIB
S11_GATCGATCATTTGCCC	APOE+ FIB
S11_AAGGTTCAGATGTTAG	FBN1+ FIB
S11_AGGGAGTCAGTCTTCC	FBN1+ FIB
S11_GATGAAAAGCTGATAA	FBN1+ FIB
S11_TACTCATAGATGCCTT	APOE+ FIB
S11_GCGCCAAAGAAACGCC	COL11A1+ FIB
S11_CAAGGCCTCCAAATGC	COL11A1+ FIB
S11_TGTCCCAAGCTGGAAC	FBN1+ FIB
S11_GATGCTAAGGAATTAC	FBN1+ FIB
S11_ACACCAAGTACTCGCG	FBN1+ FIB
S11_CGTCTACGTTGTCTTT	FBN1+ FIB
S11_GGTGTTAGTGATGATA	FBN1+ FIB
S11_AACTCAGAGCGCTTAT	COL11A1+ FIB
S11_ATCTGCCTCGAATCCA	FBN1+ FIB
S11_GGGCATCTCTTTCCTC	FBN1+ FIB
S11_GATGAGGCAACTGCGC	FBN1+ FIB
S11_GGATGTTTCCCGGATG	COL11A1+ FIB
S11_TCCCGATTCTCGCTTG	COL11A1+ FIB
S11_ACCCACTTCTACTATC	FBN1+ FIB
S11_TCGCGAGGTACTTGAC	COL11A1+ FIB
S11_GAGGTGAAGCCGCCTA	FBN1+ FIB
S11_CTGATAGAGCAGATCG	FBN1+ FIB
S11_GTGCTTCTCCTTAATC	COL11A1+ FIB
S11_GCATGCGTCATCACCC	FBN1+ FIB
S11_TCTTTCCTCAGAAATG	FBN1+ FIB
S11_ATCTGCCCAGCTGTTA	FBN1+ FIB
S11_AGGGATGGTCATATCG	COL11A1+ FIB
S11_GTTTCTATCTTAGCCC	FBN1+ FIB
S11_CTCATTAGTTGCTCCT	COL11A1+ FIB
S11_CATCGGGGTGTGACCC	COL11A1+ FIB
S11_TATCAGGGTACAGTGG	COL11A1+ FIB
S11_GAACGGATCGTTTAGG	APOE+ FIB
S11_TCCCGATCACCGAAAG	COL11A1+ FIB
S11_GTAGGCCAGTCGTTTG	APOE+ FIB
S11_GAGGTGATCAGGTTCA	FBN1+ FIB
S11_TGACTTTGTCTAGCCG	APOE+ FIB
S11_GTGTTAGGTCTGATTG	FBN1+ FIB
S11_GCTGCGAAGTTGAGAT	FBN1+ FIB
S11_TCGCGAGGTCGCATCG	Inflam. FIB
S11_GATCGTAAGATGTAAC	Inflam. FIB
S11_ACTGAGTAGAAACGCC	APOE+ FIB
S11_TGATTTCGTGACTCAT	FBN1+ FIB
S11_ATAAGAGGTACCGGCT	FBN1+ FIB
S11_GTTCGGGGTGCTCTTC	APOE+ FIB
S11_TTTGCGCTCATCTGCC	FBN1+ FIB
S11_GAGGTGAAGAGGACGG	FBN1+ FIB
S11_GGAATAAAGGCTAGCA	FBN1+ FIB
S11_TGGGAAGGTGCAACGA	APOE+ FIB
S11_CTGAAGTTCTGGTTCC	COL11A1+ FIB
S11_CAGAGAGCAAATCCGT	FBN1+ FIB
S11_GCTCTGTGTTCCATGA	APOE+ FIB
S11_AACTCAGTCACCCGAG	APOE+ FIB
S11_CCAATCCCAGTCTTCC	APOE+ FIB
S11_ACACCAATCTACCTGC	FBN1+ FIB
S11_GACGGCTAGCCTATGT	COL11A1+ FIB
S11_GGACAGACAGTAGAGC	APOE+ FIB
S11_TACTTGTGTTTGCATG	FBN1+ FIB
S11_GTAACTGTCACCGGGT	FBN1+ FIB
S11_GGAGCAATCGATCCCT	COL11A1+ FIB
S11_CTGTTTACACCGAAAG	APOE+ FIB
S11_GGACATTAGTTCGCAT	FBN1+ FIB
S11_CTAGTGACACATTCGA	APOE+ FIB
S11_GATTCAGTCCTGCAGG	FBN1+ FIB
S11_TGAGGGATCTAGAGTC	APOE+ FIB
S11_AATCCAGGTAAATGTG	COL11A1+ FIB
S11_CCATTCGAGGACAGAA	COL11A1+ FIB
S11_CTGGTCTCATCGATGT	COL11A1+ FIB
S11_GTTAAGCTCAGCAACT	FBN1+ FIB
S11_TCGCGAGGTACATGTC	FBN1+ FIB
S11_GACGTTACAGTCGTGC	FBN1+ FIB
S11_CTGCTGTCAATAGCGG	APOE+ FIB
S11_AGTGGGACATGGTCTA	APOE+ FIB
S11_CTCACACGTAAACCTC	FBN1+ FIB
S11_CGATGGCAGAGACTTA	FBN1+ FIB
S11_CACCACTCAACAACCT	FBN1+ FIB
S11_AGCGGTCAGAATTGTG	APOE+ FIB
S11_CAGCAGCTCGTGACAT	COL11A1+ FIB
S11_ACTGAGTTCCTTTCTC	FBN1+ FIB
S11_CATCGGGGTGAAGGCT	FBN1+ FIB
S11_GGGAGATTCAGTTTGG	APOE+ FIB
S11_TTGAACGCAGTCGATT	FBN1+ FIB
S11_AAACCTGCACTATCTT	FBN1+ FIB
S11_GTGCGGTTCGATGAGG	FBN1+ FIB
S11_TTGAACGCACGGTAGA	COL11A1+ FIB
S11_GCTGCAGCAAGCCATT	APOE+ FIB
S11_CGACTTCTCTCTAAGG	COL11A1+ FIB
S11_GCTGCGAGTGTGGCTC	FBN1+ FIB
S11_CTTTGCGAGAAGCCCA	COL11A1+ FIB
S11_CCGTTCACAAGCTGGA	APOE+ FIB
S11_GTCCTCACATCCCATC	APOE+ FIB
S11_CGGACACTCAGCTCTC	FBN1+ FIB
S11_CTGCGGAAGCGTGTCC	COL11A1+ FIB
S11_ATAAGAGGTGTGACCC	FBN1+ FIB
S11_AAGCCGCTCGGATGGA	FBN1+ FIB
S11_GCTCTGTTCATTTGGG	FBN1+ FIB
S11_CGTGTAATCTCTAAGG	FBN1+ FIB
S11_GTTCATTTCCCGACTT	APOE+ FIB
S11_ATAACGCCACAGAGGT	FBN1+ FIB
S11_GTGCGGTGTCTCTCTG	COL11A1+ FIB
S11_TAAGTGCTCGATCCCT	APOE+ FIB
S11_CCTTCCCAGGCAGGTT	Inflam. FIB
S11_CCGTTCATCACGCATA	FBN1+ FIB
S11_ATGCGATTCAAACCAC	Inflam. FIB
S11_GTACTCCCATGGTTGT	COL11A1+ FIB
S11_TATCTCATCCTGCAGG	Inflam. FIB
S11_GCGGGTTTCGCCAAAT	APOE+ FIB
S11_AAAGATGTCTCTGTCG	FBN1+ FIB
S11_TCATTACCATGCGCAC	APOE+ FIB
S11_CTCGGGAGTTATCGGT	APOE+ FIB
S11_GGCGACTGTTATGCGT	FBN1+ FIB
S11_GCGCAGTGTCAAGCGA	FBN1+ FIB
S11_CTCAGAATCTCTTGAT	APOE+ FIB
S11_CGCTTCAAGCGTTTAC	APOE+ FIB
S11_CTCACACCAATCCAAC	FBN1+ FIB
S11_TTTGGTTAGGTGCACA	COL11A1+ FIB
S11_AGAGCTTTCACAATGC	APOE+ FIB
S11_TCATTTGCATTCGACA	FBN1+ FIB
S11_CTGATAGAGCCAACAG	FBN1+ FIB
S11_ATGCGATTCGGACAAG	APOE+ FIB
S11_CTACCCACACGGTGTC	APOE+ FIB
S11_CTCACACAGCTATGCT	APOE+ FIB
S11_CACCAGGCACATCCAA	COL11A1+ FIB
S11_TCGTAGAGTTTGCATG	APOE+ FIB
S11_ACATGGTTCCTACAGA	COL11A1+ FIB
S11_ACACCAATCCAACCAA	APOE+ FIB
S11_CTCGTCACATACGCTA	APOE+ FIB
S11_ACGAGGAGTATTACCG	COL11A1+ FIB
S11_CACAAACTCCATGAAC	COL11A1+ FIB
S11_CATGACACATCCAACA	APOE+ FIB
S11_TTGCCGTTCCGTACAA	FBN1+ FIB
S11_AAGGTTCAGGGTGTGT	COL11A1+ FIB
S11_GGCTCGATCACCAGGC	COL11A1+ FIB
S11_TGAAAGAGTGACCAAG	APOE+ FIB
S11_AACGTTGGTCAAACTC	FBN1+ FIB
S11_ACTGCTCGTAGCTCCG	FBN1+ FIB
S11_TGACAACGTCCCTACT	APOE+ FIB
S11_GTTCGGGGTGCGCTTG	FBN1+ FIB
S11_ATCTGCCAGGAGTCTG	APOE+ FIB
S11_TCGCGTTCAGCTTAAC	APOE+ FIB
S11_TACTTGTCATCGACGC	APOE+ FIB
S11_GGCCGATAGAATGTGT	APOE+ FIB
S11_CATTCGCGTGTTTGGT	APOE+ FIB
S11_AGGTCCGGTCCGTCAG	APOE+ FIB
S11_CTCTGGTGTAAACCTC	APOE+ FIB
S11_CGAGCACAGATCCCGC	COL11A1+ FIB
S11_TAGACCAGTCTAGTCA	APOE+ FIB
S11_AGTCTTTGTTTGGGCC	FBN1+ FIB
S11_GTATTCTCAAGTAGTA	APOE+ FIB
S11_GATGAGGAGCTGAAAT	APOE+ FIB
S11_GCTGCTTCAAGTTCTG	COL11A1+ FIB
S11_AGAGTGGGTTACTGAC	APOE+ FIB
S11_CAACCTCTCAACGAAA	APOE+ FIB
S11_TACACGAGTACCGGCT	FBN1+ FIB
S11_TCATTACGTTAAGATG	FBN1+ FIB
S11_GTCGTAAGTAGGAGTC	FBN1+ FIB
S11_CGGAGTCTCTGAAAGA	COL11A1+ FIB
S11_TGCCCTATCCCATTTA	APOE+ FIB
S11_TTTACTGAGCAGGCTA	APOE+ FIB
S11_TTAGGCAAGATCTGCT	FBN1+ FIB
S11_AGCGTATAGCCGTCGT	FBN1+ FIB
S11_GTGCAGCAGCGCCTCA	APOE+ FIB
S11_AAGACCTCATCGGTTA	FBN1+ FIB
S11_CCTAAAGTCTTGCATT	APOE+ FIB
S11_TTGCCGTTCCTGCTTG	FBN1+ FIB
S11_GCGGGTTAGATGGGTC	FBN1+ FIB
S11_GGGCATCTCTACTCAT	COL11A1+ FIB
S11_CAGAATCAGACCTAGG	APOE+ FIB
S11_GACGTGCGTCCCTACT	APOE+ FIB
S11_TGTTCCGCACTTCGAA	FBN1+ FIB
S11_CAAGAAATCCTTGGTC	COL11A1+ FIB
S11_AAAGTAGCAAAGTCAA	APOE+ FIB
S11_TAGAGCTAGCGCTCCA	FBN1+ FIB
S11_GCAATCAAGTGGGCTA	COL11A1+ FIB
S11_ACAGCCGAGTGTCCCG	COL11A1+ FIB
S11_CTAATGGCATCCGCGA	FBN1+ FIB
S11_GGCGACTTCCCTCTTT	FBN1+ FIB
S11_CAACCTCTCACTGGGC	FBN1+ FIB
S11_ATCCGAACACGGTAGA	APOE+ FIB
S11_TGACGGCAGTACGATA	APOE+ FIB
S11_TGCCCTAGTTCAGACT	APOE+ FIB
S11_GTTAAGCTCAGCGACC	APOE+ FIB
S11_TGGGCGTTCTCCGGTT	Inflam. FIB
S11_CAACTAGCATAGGATA	FBN1+ FIB
S11_GTAGGCCTCACCCGAG	APOE+ FIB
S11_ATTGGACCAGGCGATA	FBN1+ FIB
S11_CCTTCCCAGTTTCCTT	FBN1+ FIB
S11_CGCTATCAGAGACTTA	FBN1+ FIB
S11_ACTGAACAGGTAAACT	APOE+ FIB
S11_GTTACAGTCAAACGGG	APOE+ FIB
S11_GGATGTTTCACCCTCA	APOE+ FIB
S11_GATTCAGAGCTAACAA	FBN1+ FIB
S11_TTAGGACAGTTATCGC	FBN1+ FIB
S11_TATTACCGTTACGTCA	FBN1+ FIB
S11_GCAGTTATCGTTACAG	COL11A1+ FIB
S11_GTAGGCCAGTAGCGGT	FBN1+ FIB
S11_ACACCAACAAAGTGCG	FBN1+ FIB
S11_CCCTCCTAGGGATACC	APOE+ FIB
S11_CATGACAAGGTGCTTT	FBN1+ FIB
S11_GCACATATCCTGCAGG	FBN1+ FIB
S11_TGCCCATGTTTGTTGG	APOE+ FIB
S11_AACGTTGTCACGATGT	APOE+ FIB
S11_AACGTTGCAAACGTGG	APOE+ FIB
S11_AGGTCATTCTCATTCA	APOE+ FIB
S11_AAACCTGTCCTCAACC	APOE+ FIB
S11_TCGCGTTTCTTTACGT	FBN1+ FIB
S11_GGCGACTTCCTCAACC	APOE+ FIB
S11_TCAGCAAGTCACCTAA	APOE+ FIB
S11_TACTTACCAGCCACCA	APOE+ FIB
S11_CTCAGAACATTTCAGG	APOE+ FIB
S11_GAGGTGAGTTCCACGG	APOE+ FIB
S11_TAGGCATAGTATCGAA	APOE+ FIB
S11_CCCAATCCAAATTGCC	FBN1+ FIB
S11_AACCATGCATGGAATA	FBN1+ FIB
S11_GGAAAGCTCAATCTCT	FBN1+ FIB
S11_TTCTCAATCAGAAATG	APOE+ FIB
S11_CAACCTCCACAGTCGC	FBN1+ FIB
S11_AGCAGCCAGCTAGTGG	FBN1+ FIB
S11_ATGCGATAGTGAATTG	APOE+ FIB
S11_GTACGTAGTCCGACGT	APOE+ FIB
S11_CATTATCTCTCACATT	APOE+ FIB
S11_GACGTTAGTGACGCCT	COL11A1+ FIB
S11_GGGACCTTCTGCTGCT	FBN1+ FIB
S11_TGATTTCGTCGAGATG	FBN1+ FIB
S11_TCAGATGTCAGTTTGG	FBN1+ FIB
S11_AGGGTGAAGAATGTGT	APOE+ FIB
S11_GCTGCTTCATTACGAC	FBN1+ FIB
S11_GAACATCTCACATAGC	APOE+ FIB
S11_TTCTACAGTAAGGGCT	APOE+ FIB
S11_ATCTACTTCGCAAGCC	COL11A1+ FIB
S11_CGAGCCAGTATAATGG	APOE+ FIB
S11_GTTAAGCTCGAATGGG	FBN1+ FIB
S11_AGACGTTGTCCGAGTC	COL11A1+ FIB
S11_GACCAATAGTTGTAGA	COL11A1+ FIB
S11_CTCGAGGCATGTCCTC	FBN1+ FIB
S11_CGGAGCTGTAGATTAG	APOE+ FIB
S11_CGGAGTCGTCCCGACA	APOE+ FIB
S11_AGCTCTCAGACAATAC	APOE+ FIB
S11_TACAGTGAGCCACGTC	FBN1+ FIB
S11_AAACCTGAGATCTGCT	FBN1+ FIB
S11_CACATAGGTTTAGCTG	COL11A1+ FIB
S11_CTCAGAAAGGGCTTGA	APOE+ FIB
S11_CTCGTCACAACACCTA	APOE+ FIB
S11_GTGCAGCAGGGCACTA	FBN1+ FIB
S11_AGGCCACGTCAATGTC	APOE+ FIB
S11_TTAACTCGTATATGAG	APOE+ FIB
S11_ACCCACTGTTGTCGCG	APOE+ FIB
S11_CTAGTGAAGTGCCATT	FBN1+ FIB
S11_TCTGAGATCATGTCTT	APOE+ FIB
S11_TAAGCGTAGCGACGTA	APOE+ FIB
S11_GAAATGAAGACCTAGG	FBN1+ FIB
S11_TGCACCTGTATATGAG	APOE+ FIB
S11_CTTACCGGTTACTGAC	APOE+ FIB
S11_GCAAACTTCTGCCCTA	APOE+ FIB
S11_TTCTACACACCGCTAG	FBN1+ FIB
S11_TTAGGCACAGCGAACA	FBN1+ FIB
S11_CCTCTGACAATGGAGC	APOE+ FIB
S11_CAGCGACGTCTCGTTC	APOE+ FIB
S11_TGATTTCCAAACGTGG	FBN1+ FIB
S11_ATCACGAGTCTGCCAG	FBN1+ FIB
S11_TGCCAAAAGACAGGCT	FBN1+ FIB
S11_AGACGTTGTTCCCGAG	APOE+ FIB
S11_GATGAGGCACCATCCT	APOE+ FIB
S11_ACGCCAGTCCACTCCA	COL11A1+ FIB
S11_GCGGGTTTCCCTCAGT	COL11A1+ FIB
S11_CATCAGAAGTTACGGG	APOE+ FIB
S11_CGTAGGCGTCCAGTAT	COL11A1+ FIB
S11_GTGCTTCCAAGAGGCT	APOE+ FIB
S11_AGTGAGGTCTTTACGT	COL11A1+ FIB
S11_CCTATTAGTAGCGCTC	APOE+ FIB
S11_AGCCTAACATTCTCAT	COL11A1+ FIB
S11_TGTATTCTCGGAGCAA	APOE+ FIB
S11_CAACTAGCAATCCAAC	APOE+ FIB
S11_TCTTTCCGTACATGTC	APOE+ FIB
S11_TTTCCTCCAGATTGCT	APOE+ FIB
S11_ACACTGATCGGAAATA	APOE+ FIB
S11_AGGGAGTTCGGCCGAT	APOE+ FIB
S11_ACTATCTCACAACGCC	FBN1+ FIB
S11_GTTAAGCTCGGCTTGG	FBN1+ FIB
S11_CGCCAAGGTAAATGAC	FBN1+ FIB
S11_AGCTCTCCACAACTGT	APOE+ FIB
S11_CGCTATCCAAGCGTAG	COL11A1+ FIB
S11_TCAGGTAAGCTGATAA	FBN1+ FIB
S11_GAATGAATCCGCAAGC	COL11A1+ FIB
S11_CCACGGAAGGCAGTCA	APOE+ FIB
S11_CAGATCAAGGGCTTGA	APOE+ FIB
S11_CACACAATCACGCGGT	APOE+ FIB
S11_CGATGTATCGTTTATC	APOE+ FIB
S11_CCTCTGACAGATGGGT	FBN1+ FIB
S11_CGAATGTGTATAATGG	APOE+ FIB
S11_CTCTAATTCTCGAGTA	FBN1+ FIB
S11_TACTTGTGTCAAAGCG	APOE+ FIB
S11_GGACAAGCATCACGAT	APOE+ FIB
S11_GATCAGTAGGCCGAAT	FBN1+ FIB
S11_GACGTTAAGGCTAGAC	APOE+ FIB
S11_GTCTCGTGTTTGACTG	APOE+ FIB
S11_TTCGGTCAGTCGAGTG	FBN1+ FIB
S11_ATCTACTTCGTGACAT	APOE+ FIB
S11_GCCAAATGTTGTGGCC	APOE+ FIB
S11_GATCAGTCAATGGAAT	FBN1+ FIB
S11_ACGGAGAAGCACAGGT	APOE+ FIB
S11_ATCCACCAGACGCACA	APOE+ FIB
S11_CTCGGGATCCACGACG	APOE+ FIB
S11_TTGACTTTCAGGTAAA	FBN1+ FIB
S11_GTGCGGTGTAAATACG	FBN1+ FIB
S11_CAGTCCTTCTTGTACT	FBN1+ FIB
S11_GAAATGATCAGTTGAC	APOE+ FIB
S11_GTGCTTCAGTGTTTGC	APOE+ FIB
S11_ATGAGGGAGATGTGTA	FBN1+ FIB
S11_AGGCCACAGAAACCTA	APOE+ FIB
S11_TACTCATTCGAATGCT	APOE+ FIB
S11_CGAATGTTCTCAACTT	FBN1+ FIB
S11_CATTATCTCCTATGTT	FBN1+ FIB
S11_CAGCATACAGGTCCAC	APOE+ FIB
S11_CCTACACCATGCAACT	FBN1+ FIB
S11_AGAATAGAGTGGAGTC	FBN1+ FIB
S11_CCATTCGGTTCTGAAC	APOE+ FIB
S11_TTGCGTCCACCAACCG	APOE+ FIB
S11_GCGCAACCATGCCTAA	FBN1+ FIB
S11_GTCATTTGTGGCTCCA	COL11A1+ FIB
S11_CATATTCGTCCGACGT	FBN1+ FIB
S11_TGAGAGGCAGAGCCAA	APOE+ FIB
S11_ATTACTCCATATGAGA	APOE+ FIB
S11_CGGACTGTCCCATTTA	COL11A1+ FIB
S11_TGCCCATCATCGGTTA	APOE+ FIB
S11_CTAAGACTCATTATCC	APOE+ FIB
S11_ACGATACAGGACCACA	COL11A1+ FIB
S11_ATCGAGTGTCGGATCC	FBN1+ FIB
S11_GACCTGGTCGGTTCGG	APOE+ FIB
S11_GTTTCTATCTGGCGAC	APOE+ FIB
S11_TTCCCAGCAGTGACAG	COL11A1+ FIB
S11_GTTCTCGTCCTAGTGA	APOE+ FIB
S11_TTCTACAGTATGAAAC	Inflam. FIB
S11_GTTCTCGGTCGCTTTC	FBN1+ FIB
S11_CGAGCCAGTCAGAATA	APOE+ FIB
S11_GTCTCGTTCGTCACGG	APOE+ FIB
S11_AGACGTTTCAGTTGAC	Inflam. FIB
S11_GGACAGATCATGCAAC	FBN1+ FIB
S11_GGACAAGGTAGGACAC	APOE+ FIB
S11_TGTTCCGTCACTATTC	APOE+ FIB
S11_GCAATCACACGGTAAG	APOE+ FIB
S11_TTGTAGGCATGACGGA	APOE+ FIB
S11_CAGCATATCGACAGCC	APOE+ FIB
S11_TTCTCAACAACACCTA	APOE+ FIB
S11_ACGATACAGCGTGTCC	APOE+ FIB
S11_CACTCCAAGTTCGATC	APOE+ FIB
S11_TAGTTGGTCGCTAGCG	FBN1+ FIB
S11_TTAGGCAGTTTGTTTC	COL11A1+ FIB
S11_GGGCACTGTTCGTCTC	COL11A1+ FIB
S11_GATCGTAAGTGGTAAT	APOE+ FIB
S11_TACGGTAGTCGATTGT	APOE+ FIB
S11_TGACTTTCAATTGCTG	FBN1+ FIB
S11_AAAGCAACACACTGCG	FBN1+ FIB
S11_TGGCTGGCAGACAAAT	APOE+ FIB
S11_GTGCGGTTCTCCGGTT	APOE+ FIB
S11_GTTTCTAAGAGCTTCT	FBN1+ FIB
S11_ACACCCTGTCATATCG	APOE+ FIB
S11_ATCATGGCACGGTAGA	APOE+ FIB
S11_GCCAAATCACAGAGGT	COL11A1+ FIB
S11_GGGATGATCTAACTTC	FBN1+ FIB
S11_GGTGAAGTCCTACAGA	APOE+ FIB
S11_TACAGTGAGGCAGTCA	COL11A1+ FIB
S11_CTACGTCCAAGTTCTG	FBN1+ FIB
S11_TAAGTGCAGACAATAC	FBN1+ FIB
S11_TAGAGCTAGTGAAGTT	APOE+ FIB
S11_GATGAGGTCACAATGC	APOE+ FIB
S11_CTAGCCTGTCGAACAG	FBN1+ FIB
S11_CGGACGTCATTTCACT	APOE+ FIB
S11_GGTGAAGAGCCCTAAT	APOE+ FIB
S11_TTGAACGAGTCTCAAC	APOE+ FIB
S11_CTGCTGTGTTTGCATG	APOE+ FIB
S11_TGAGCATGTCTAAACC	APOE+ FIB
S11_CACATAGGTCTCAACA	APOE+ FIB
S11_CTACCCATCAACGGGA	APOE+ FIB
S11_TAGCCGGCATGTAAGA	APOE+ FIB
S11_GTATTCTTCTTCTGGC	APOE+ FIB
S11_GACAGAGGTTTGACAC	COL11A1+ FIB
S11_AGTGTCATCGCCTGTT	FBN1+ FIB
S11_GAAGCAGCAACTTGAC	FBN1+ FIB
S11_TGCTGCTGTACACCGC	APOE+ FIB
S11_ACAGCTATCACCGTAA	FBN1+ FIB
S11_CACATTTTCGTGGGAA	FBN1+ FIB
S11_GTACTCCCAGGGCATA	APOE+ FIB
S11_CAAGAAATCTTCAACT	APOE+ FIB
S11_CATATTCGTTGGTGGA	COL11A1+ FIB
S11_CGTTGGGCAAGCCATT	APOE+ FIB
S11_CGTTAGAAGGATATAC	COL11A1+ FIB
S11_TGCTACCTCACCACCT	APOE+ FIB
S11_GTCTTCGGTAGCACGA	APOE+ FIB
S11_TCGTAGATCGACAGCC	APOE+ FIB
S11_CCACGGATCTAAGCCA	FBN1+ FIB
S11_TTCGGTCCAATGTTGC	FBN1+ FIB
S11_TGGCTGGGTTCGTGAT	APOE+ FIB
S11_TATGCCCGTAGTACCT	APOE+ FIB
S11_ATCATCTAGAACAACT	APOE+ FIB
S11_CAGCTGGTCACGACTA	APOE+ FIB
S11_AGAATAGAGTCAATAG	APOE+ FIB
S11_ATCATGGGTACCGCTG	APOE+ FIB
S11_ACGCCAGTCTACCAGA	APOE+ FIB
S11_ATAACGCTCAAGGTAA	FBN1+ FIB
S11_AACTCAGTCGTCTGCT	APOE+ FIB
S11_ACGGGTCCAAACAACA	APOE+ FIB
S11_CCAATCCGTAACGCGA	APOE+ FIB
S11_CATTATCAGCCACGTC	FBN1+ FIB
S11_TGTATTCAGATGTGTA	FBN1+ FIB
S11_CTGCTGTGTCTGCGGT	FBN1+ FIB
S11_CTCTAATCAAGCCCAC	COL11A1+ FIB
S11_CCAATCCTCCGTTGTC	COL11A1+ FIB
S11_CGATGGCTCGATGAGG	APOE+ FIB
S11_TCTGGAACACACATGT	APOE+ FIB
S11_GCGCAGTCACTTCGAA	APOE+ FIB
S11_ACGAGGATCTCTAGGA	APOE+ FIB
S11_ATAGACCCATGCATGT	APOE+ FIB
S11_TGTATTCGTCAGAAGC	FBN1+ FIB
S11_TGAGAGGGTCAGAGGT	APOE+ FIB
S11_ACACTGAAGTGGGCTA	COL11A1+ FIB
S11_ACATACGGTCGAACAG	APOE+ FIB
S11_CATCAAGAGGTGATAT	FBN1+ FIB
S11_CTGCCTACACTTCTGC	APOE+ FIB
S11_CCAATCCAGGGTTCCC	APOE+ FIB
S11_CTGTGCTCACTTAAGC	APOE+ FIB
S11_TCACAAGTCTGAGTGT	APOE+ FIB
S11_TAGACCATCTGACCTC	APOE+ FIB
S11_ACGATACGTACAGTTC	APOE+ FIB
S11_GACGCGTTCTTGCAAG	FBN1+ FIB
S11_CAGCAGCTCTTGAGGT	APOE+ FIB
S11_CACCACTGTCTCACCT	APOE+ FIB
S11_AGCTCTCAGAATTCCC	APOE+ FIB
S11_GCTGGGTTCGAGAACG	APOE+ FIB
S11_TGAGCATGTTCGTGAT	APOE+ FIB
S11_AGAGCGACACGCTTTC	FBN1+ FIB
S11_GATGAGGAGCACGCCT	APOE+ FIB
S11_GGACAAGTCGCGGATC	COL11A1+ FIB
S11_CCTACACAGACTTTCG	APOE+ FIB
S11_CTCACACAGTGGACGT	APOE+ FIB
S11_GTGTTAGAGATATGGT	COL11A1+ FIB
S11_TTCTTAGGTATAATGG	APOE+ FIB
S11_ACGATACAGCCAACAG	APOE+ FIB
S11_AGCGTCGAGACTTTCG	FBN1+ FIB
S11_CGTAGGCTCCCATTAT	APOE+ FIB
S11_CTAGAGTAGTCCGTAT	Inflam. FIB
S11_AGCGGTCTCAACACAC	COL11A1+ FIB
S11_CACCTTGCATTCTTAC	APOE+ FIB
S11_CATTATCTCGCGTTTC	FBN1+ FIB
S11_ATGCGATCATCCGCGA	APOE+ FIB
S11_TTTGTCAGTCTTGATG	APOE+ FIB
S11_TAGACCAAGTGGCACA	APOE+ FIB
S11_TGAGGGACACAGGCCT	FBN1+ FIB
S11_TGGACGCCATCGTCGG	APOE+ FIB
S11_ACTGCTCGTGTGGCTC	COL11A1+ FIB
S11_GGACAAGGTCGAGATG	COL11A1+ FIB
S11_ACCCACTTCCTTCAAT	COL11A1+ FIB
S11_GCAGTTACACGAGAGT	APOE+ FIB
S11_GGAATAACAATAAGCA	COL11A1+ FIB
S11_GTACTTTAGTGCGTGA	APOE+ FIB
S11_TGCGTGGGTGTAACGG	APOE+ FIB
S11_CATCGAACAATCTGCA	APOE+ FIB
S11_GGATGTTTCGAGCCCA	APOE+ FIB
S11_TACTCATGTGTGGCTC	APOE+ FIB
S11_GCGAGAATCAATAAGG	FBN1+ FIB
S11_CCGGGATAGCTCCCAG	FBN1+ FIB
S11_TACTTGTCAGATGGCA	APOE+ FIB
S11_TCAGCAAAGACACTAA	COL11A1+ FIB
S11_TCAGGTAGTGTAATGA	FBN1+ FIB
S11_TATCAGGGTGCTCTTC	APOE+ FIB
S11_AACCGCGGTTAAGGGC	APOE+ FIB
S11_CTCGGAGGTGTAAGTA	APOE+ FIB
S11_TGACAACTCGTATCAG	FBN1+ FIB
S11_CAGAATCTCGCAAACT	APOE+ FIB
S11_CATCGAAAGTGACATA	FBN1+ FIB
S11_GAAACTCAGGCCCTCA	APOE+ FIB
S11_AAGGCAGGTCTTTCAT	APOE+ FIB
S11_AGCTCCTTCAAAGACA	FBN1+ FIB
S11_CATGCCTGTATGAAAC	COL11A1+ FIB
S11_GGAGCAACATCACAAC	APOE+ FIB
S11_ATCTACTAGAAGATTC	APOE+ FIB
S11_CTGATAGTCGCAAGCC	COL11A1+ FIB
S11_GACGCGTAGGAACTGC	APOE+ FIB
S11_TGGTTAGAGTCGTACT	APOE+ FIB
S11_ACTGCTCGTGTGCGTC	COL11A1+ FIB
S11_ACGGAGAGTAGAAAGG	APOE+ FIB
S11_ATCCACCTCTCTGAGA	COL11A1+ FIB
S11_GTCTCGTGTGCAACGA	APOE+ FIB
S11_TTTCCTCAGAGGTTGC	APOE+ FIB
S11_GTAACGTTCAATCACG	APOE+ FIB
S11_CTTCTCTTCAGTTTGG	APOE+ FIB
S11_AGCTTGAGTTAAGAAC	FBN1+ FIB
S11_AAGCCGCAGAAACCGC	APOE+ FIB
S11_CTCTACGCAACACGCC	FBN1+ FIB
S11_CGAGCACCATCACCCT	COL11A1+ FIB
S11_TCGGGACCAACGCACC	FBN1+ FIB
S11_GAACGGAGTCGCTTTC	APOE+ FIB
S11_TGCCCATTCCTTTACA	APOE+ FIB
S11_CAAGGCCAGTGAATTG	APOE+ FIB
S11_CATCGAAAGTCCTCCT	APOE+ FIB
S11_GAGTCCGGTATGAATG	APOE+ FIB
S11_CCTTCCCTCACCTCGT	APOE+ FIB
S11_CACACAACACATGGGA	COL11A1+ FIB
S11_CAGATCATCCGTTGCT	APOE+ FIB
S11_TGTCCCACAGGCTGAA	APOE+ FIB
S11_GTTACAGAGAGTCGGT	FBN1+ FIB
S11_CTCGGAGGTACATCCA	APOE+ FIB
S11_AACTTTCCAGCCTTGG	APOE+ FIB
S11_CCTCTGAGTTTGACAC	APOE+ FIB
S11_CTGAAACTCTAACTCT	APOE+ FIB
S11_GCCTCTAGTGTGACGA	APOE+ FIB
S11_CACATAGAGCGAAGGG	FBN1+ FIB
S11_GGACAAGTCGTACCGG	APOE+ FIB
S11_AAAGTAGCAGTCACTA	APOE+ FIB
S11_CTCTAATGTAATCACC	APOE+ FIB
S11_CGCTTCAGTTGGTGGA	APOE+ FIB
S11_ATCTGCCGTGTGACCC	APOE+ FIB
S11_GCATGTACAAACGCGA	FBN1+ FIB
S11_CGGACACTCGCCCTTA	APOE+ FIB
S11_TTGGCAAAGGTGTGGT	FBN1+ FIB
S11_TGGACGCCAAGTTCTG	APOE+ FIB
S11_TCTATTGGTTGGTGGA	FBN1+ FIB
S11_CTCGTACGTTATGCGT	APOE+ FIB
S11_ATTTCTGGTATCAGTC	APOE+ FIB
S11_CGTAGGCTCATCGCTC	APOE+ FIB
S11_ATTTCTGTCCGAACGC	APOE+ FIB
S11_CTAATGGAGCGCCTCA	FBN1+ FIB
S11_GTATTCTTCCAGATCA	APOE+ FIB
S11_CCGGGATCAGGCTGAA	APOE+ FIB
S11_GTGCTTCCAGATGGGT	FBN1+ FIB
S11_ACCCACTTCTTACCTA	FBN1+ FIB
S11_TGGTTAGAGACCACGA	APOE+ FIB
S11_ATGGGAGTCAGGATCT	COL11A1+ FIB
S11_TCTGAGATCTGGTATG	FBN1+ FIB
S11_TCTTTCCGTAGGAGTC	FBN1+ FIB
S11_CAGCCGATCATGCTCC	APOE+ FIB
S11_CTAATGGAGAGCTTCT	APOE+ FIB
S11_CACCTTGCAAGTCTGT	COL11A1+ FIB
S11_TTCGAAGTCCTTGACC	APOE+ FIB
S11_ACAGCCGCAGCTCGAC	Inflam. FIB
S11_GCACTCTCATTCCTCG	FBN1+ FIB
S11_GTACTTTAGGCAGGTT	FBN1+ FIB
S11_GCATGTAGTTCCACGG	COL11A1+ FIB
S11_TCAACGACAAGCGATG	APOE+ FIB
S11_GTATTCTAGGAGTCTG	APOE+ FIB
S11_ATGGGAGAGCGATATA	APOE+ FIB
S11_GGAGCAACAGATGGCA	APOE+ FIB
S11_CCGTTCACAATAGCGG	APOE+ FIB
S11_ATCGAGTAGTACGACG	APOE+ FIB
S11_CGGACGTAGCCACGTC	APOE+ FIB
S11_CGTCAGGTCGCAGGCT	APOE+ FIB
S11_GGGAGATAGCTGTCTA	APOE+ FIB
S11_CGAGCCACAACGATCT	FBN1+ FIB
S11_CTAGTGACACATGGGA	COL11A1+ FIB
S11_ACTATCTGTCTTCGTC	APOE+ FIB
S11_CTGATCCTCTGTCCGT	APOE+ FIB
S11_ACGATGTGTCTCCACT	APOE+ FIB
S11_TATTACCAGCTACCGC	APOE+ FIB
S11_TCTATTGCAATGTAAG	APOE+ FIB
S11_GAAATGAGTGGTACAG	FBN1+ FIB
S11_TCTATTGTCAGAGGTG	APOE+ FIB
S11_GGTGTTAGTAGCGATG	FBN1+ FIB
S11_GTAACGTAGTGTGAAT	APOE+ FIB
S11_TCATTACGTAAACGCG	APOE+ FIB
S11_AGGTCATGTTCCATGA	APOE+ FIB
S11_GCACATAAGGACAGCT	APOE+ FIB
S11_CAGCTAAAGGCTCATT	APOE+ FIB
S11_TTTCCTCGTTCGTGAT	FBN1+ FIB
S11_AGTGAGGCATTGAGCT	APOE+ FIB
S11_TGTGTTTCATCACCCT	FBN1+ FIB
S11_GATCGCGAGGTGCAAC	APOE+ FIB
S11_GCTCCTAAGGGTGTGT	FBN1+ FIB
S11_CACAAACCACGAAAGC	APOE+ FIB
S11_TGTCCCAGTTATGCGT	APOE+ FIB
S11_TGCACCTAGCTGGAAC	FBN1+ FIB
S11_TGAGGGAAGAGGGATA	FBN1+ FIB
S11_CTAGCCTAGTGGAGTC	APOE+ FIB
S11_TCTATTGGTGGTCCGT	APOE+ FIB
S11_AGCAGCCGTTAAAGTG	COL11A1+ FIB
S11_CTTGGCTCACCGTTGG	APOE+ FIB
S11_GCCAAATCAATGGACG	FBN1+ FIB
S11_CCTACCATCTCAACTT	APOE+ FIB
S11_CACACAACAGTTTACG	APOE+ FIB
S11_AACCGCGTCGGTCCGA	APOE+ FIB
S11_GTAACGTCAGCCAGAA	APOE+ FIB
S11_CGGGTCAGTTCCCGAG	Inflam. FIB
S11_TCAACGAAGAGTACCG	APOE+ FIB
S11_AGTGAGGAGGGCACTA	FBN1+ FIB
S11_CACAGGCAGGATGCGT	APOE+ FIB
S11_CAGCTGGGTCAAAGCG	Inflam. FIB
S11_CAACCAACAGCTATTG	FBN1+ FIB
S11_GCTGCTTAGTGAACAT	FBN1+ FIB
S11_ACTTGTTGTCCGTTAA	APOE+ FIB
S11_GCGCAGTTCTGCTTGC	APOE+ FIB
S11_TCACGAAGTTGAGGTG	APOE+ FIB
S11_GAGGTGACATCTATGG	APOE+ FIB
S11_TTAGGCAGTACAGTTC	APOE+ FIB
S11_CTCCTAGCAATGAAAC	COL11A1+ FIB
S11_CTTACCGTCATCATTC	APOE+ FIB
S11_CAGCTGGTCATACGGT	APOE+ FIB
S11_CGATGGCCACCACCAG	COL11A1+ FIB
S11_CTGATCCGTCAGGACA	APOE+ FIB
S11_TGGCGCATCAATACCG	APOE+ FIB
S11_TCACAAGGTTGAGTTC	Inflam. FIB
S14_ACAGCTAGTCACACGC	Inflam. FIB
S14_TGCTACCTCATCGGAT	COL11A1+ FIB
S14_TCAGATGCACTTCTGC	FBN1+ FIB
S14_GACGCGTCAAGCCCAC	COL11A1+ FIB
S14_CACAAACGTCACAAGG	APOE+ FIB
S14_CCTTCCCGTTGCCTCT	Inflam. FIB
S14_GGCGACTCAGACGCAA	COL11A1+ FIB
S14_TGCACCTTCGAATCCA	APOE+ FIB
S14_CGATTGATCTCATTCA	FBN1+ FIB
S14_GCTGCGAAGCAGCGTA	APOE+ FIB
S14_GCCAAATCATCGACGC	FBN1+ FIB
S14_TGCACCTTCTGCCAGG	Inflam. FIB
S14_AACTTTCGTAAGTTCC	APOE+ FIB
S14_AACACGTGTCTAAACC	APOE+ FIB
S14_CGTAGGCCACCCTATC	APOE+ FIB
S14_CATATGGGTAGCGTCC	FBN1+ FIB
S14_GTGTTAGAGACAATAC	APOE+ FIB
S14_TGACAACCACGCCAGT	Inflam. FIB
S14_CTGGTCTCATGGGACA	FBN1+ FIB
S14_TTTGTCATCAACCAAC	APOE+ FIB
S14_GACTGCGAGGACGAAA	APOE+ FIB
S14_CACTCCAGTTATTCTC	APOE+ FIB
S14_GGACATTTCTTCATGT	Inflam. FIB
S14_AGACGTTTCCACGCAG	COL11A1+ FIB
S14_AGCGTATTCGTTACAG	APOE+ FIB
S14_CACACCTCAATAGCGG	FBN1+ FIB
S14_ACATGGTCAAGACACG	APOE+ FIB
S14_CTGCCTAGTCACTGGC	APOE+ FIB
S14_TTCTCCTTCTTACCGC	APOE+ FIB
S14_GAACGGATCCCTCTTT	APOE+ FIB
S14_TAAGTGCAGGACACCA	APOE+ FIB
S14_CCTTCCCCAGTAGAGC	APOE+ FIB
S14_CCGTTCATCTTTAGTC	APOE+ FIB
S14_CACATTTTCATGTGGT	Inflam. FIB
S14_TCAGGTAAGCTAGTCT	FBN1+ FIB
S14_CTCGTCACACCCATTC	APOE+ FIB
S14_GTCTTCGAGGTTACCT	FBN1+ FIB
S14_CAGTAACTCAGTACGT	COL11A1+ FIB
S14_ATCCACCCACACGCTG	FBN1+ FIB
S14_CCTATTATCTTTCCTC	APOE+ FIB
S14_ACGAGGAGTCTAACGT	FBN1+ FIB
S14_CCCTCCTTCCGCATCT	FBN1+ FIB
S14_GTTAAGCTCTGCCAGG	FBN1+ FIB
S14_GTCGTAAAGGCAAAGA	APOE+ FIB
S14_GAACGGACAAGGTTTC	APOE+ FIB
S14_ATGCGATCAATGGAGC	APOE+ FIB
S14_CTGAAACGTGGCAAAC	APOE+ FIB
S14_CTAGTGAAGAAACGAG	COL11A1+ FIB
S14_AGGGTGACATGTAAGA	APOE+ FIB
S14_CGTCAGGCATATGAGA	FBN1+ FIB
S14_GGATTACGTATCACCA	APOE+ FIB
S14_TGGCGCACACCACCAG	APOE+ FIB
S14_GTATTCTAGTTAGGTA	FBN1+ FIB
S14_TCGGTAAGTCTAAAGA	APOE+ FIB
S14_AGGTCCGAGACGACGT	FBN1+ FIB
S14_TAGACCATCCTTGGTC	APOE+ FIB
S14_TCGCGAGTCAAAGTAG	Inflam. FIB
S14_GTTCTCGCAAGTTCTG	APOE+ FIB
S14_GCAGCCATCCATGAAC	FBN1+ FIB
S14_ACTGAACAGATGTAAC	APOE+ FIB
S14_CACAGTATCGCAAACT	APOE+ FIB
S14_TAAGTGCCATTCGACA	APOE+ FIB
S14_GTCTCGTAGAAGATTC	APOE+ FIB
S14_TTAGGACCAATGACCT	APOE+ FIB
S14_ATCCACCAGTGGGCTA	APOE+ FIB
S14_GATCGCGGTCAGAGGT	APOE+ FIB
S14_GCTTGAATCGTCCAGG	APOE+ FIB
S14_AACTCAGCACATGACT	FBN1+ FIB
S14_CTCTAATGTACCATCA	FBN1+ FIB
S14_AACTCAGCACACCGCA	FBN1+ FIB
S14_GATCGCGAGCCCAATT	COL11A1+ FIB
S14_GCTGCTTTCCTCAACC	Inflam. FIB
S14_AGTCTTTTCACGATGT	APOE+ FIB
S14_CCGTACTCAAGACACG	APOE+ FIB
S14_TGGCTGGGTTCGCGAC	APOE+ FIB
S14_ATGGGAGTCTGATACG	APOE+ FIB
S14_ACGAGGATCGGATGTT	APOE+ FIB
S14_CGTCAGGGTCTCCACT	APOE+ FIB
S14_TAAACCGCACCTATCC	FBN1+ FIB
S14_TGACTAGAGGAGTACC	Inflam. FIB
S14_GAAACTCCACCCATGG	APOE+ FIB
S14_AACTGGTGTTGAGTTC	FBN1+ FIB
S14_GGACAAGTCCGCAAGC	APOE+ FIB
S14_AGGCCACAGACAAGCC	APOE+ FIB
S14_TCAGGATGTCTCTTTA	FBN1+ FIB
S14_ACCAGTATCATGCTCC	Inflam. FIB
S14_TCACGAAAGACAGACC	APOE+ FIB
S14_CTACATTGTCTAACGT	APOE+ FIB
S14_TGCGGGTTCCTGTAGA	APOE+ FIB
S14_CGATGTACACGAAAGC	APOE+ FIB
S14_ACGGGCTAGTTAAGTG	FBN1+ FIB
S14_GTAACGTTCGCCGTGA	FBN1+ FIB
S14_AGGTCCGAGTGGTAAT	APOE+ FIB
S14_CTAGCCTAGACAATAC	APOE+ FIB
S14_AGCTTGACAACTTGAC	FBN1+ FIB
S14_TGCCAAATCTGGTGTA	APOE+ FIB
S14_GTACTCCGTTAAGACA	APOE+ FIB
S14_ACGGAGACATGCTGGC	APOE+ FIB
S14_GTCACAACAATCTGCA	FBN1+ FIB
S14_TACCTTAGTAGGCTGA	APOE+ FIB
S14_CTCTACGCATCACAAC	APOE+ FIB
S14_CAGCAGCTCGTAGGAG	APOE+ FIB
S14_AGTGGGAGTCATCGGC	FBN1+ FIB
S14_TCAATCTAGATGTGGC	FBN1+ FIB
S14_GTACGTATCATGCTCC	FBN1+ FIB
S14_TCGTAGATCTGACCTC	FBN1+ FIB
S14_CGTCCATAGTCAAGCG	APOE+ FIB
S14_CGACTTCAGAGGTAGA	APOE+ FIB
S14_ATCCGAAGTCCGTTAA	APOE+ FIB
S14_CTGCCTATCGGCGGTT	FBN1+ FIB
S14_CCACGGACATTGGGCC	FBN1+ FIB
S14_CAGATCACATCCTAGA	APOE+ FIB
S14_GCATGCGCACCCTATC	APOE+ FIB
S14_ATCATGGTCCTTGACC	APOE+ FIB
S14_TTCGAAGTCAGAGCTT	APOE+ FIB
S14_TAGACCAGTCACCTAA	APOE+ FIB
S14_GACAGAGTCCGAGCCA	APOE+ FIB
S14_GCGCAGTCACTTAAGC	FBN1+ FIB
S14_CGTCACTGTCATATGC	FBN1+ FIB
S14_TTGACTTCATCCGGGT	FBN1+ FIB
S14_GCAGTTACAATGGAGC	APOE+ FIB
S14_TTCCCAGTCTGCCAGG	FBN1+ FIB
S14_GTATCTTCATTTGCTT	FBN1+ FIB
S14_AAAGCAAAGAAGGTTT	APOE+ FIB
S14_GGGCACTTCCGAAGAG	APOE+ FIB
S14_CCTTCCCTCGGGAGTA	APOE+ FIB
S14_TTTACTGTCTAGCACA	APOE+ FIB
S14_CTCGTCAGTTATGTGC	FBN1+ FIB
S14_CCCAGTTCACCGAATT	APOE+ FIB
S14_CATTATCAGGCATGTG	APOE+ FIB
S14_GCGGGTTGTGTGCGTC	Inflam. FIB
S14_ACAGCTAGTTGATTCG	FBN1+ FIB
S14_ATAACGCTCTCATTCA	APOE+ FIB
S14_GTGCTTCCATACTACG	APOE+ FIB
S14_ATGCGATCAGTTCATG	APOE+ FIB
S14_ATGTGTGCACATCTTT	APOE+ FIB
S14_CACACTCTCAGCCTAA	APOE+ FIB
S14_TTCTCCTAGATCACGG	APOE+ FIB
S14_AACGTTGCACCACGTG	FBN1+ FIB
S14_AAAGTAGCAGCTCGAC	FBN1+ FIB
S14_GCATACACATTAACCG	COL11A1+ FIB
S14_ACTTACTTCACGAAGG	COL11A1+ FIB
S14_TATCAGGTCTCCAGGG	FBN1+ FIB
S14_CGTGTAAGTGTGAATA	APOE+ FIB
S14_CCACGGAGTCATCCCT	FBN1+ FIB
S14_GTCAAGTAGGCCGAAT	FBN1+ FIB
S14_CGAGCCAAGCCAACAG	APOE+ FIB
S14_CTCGAGGCATCTGGTA	APOE+ FIB
S14_TGATTTCTCTTAGCCC	APOE+ FIB
S14_TGGCGCACAAAGCAAT	FBN1+ FIB
S14_CACACTCCATGGTCTA	COL11A1+ FIB
S14_CTGCGGATCGCAAGCC	COL11A1+ FIB
S14_ATTGGTGTCAGCTCTC	APOE+ FIB
S14_TGGACGCGTATAAACG	APOE+ FIB
S14_GTACGTATCACATAGC	APOE+ FIB
S14_TCAATCTAGATGTAAC	FBN1+ FIB
S14_CTTACCGGTCGACTAT	APOE+ FIB
S14_TTGTAGGGTTTACTCT	COL11A1+ FIB
S14_TCCACACCACAAGCCC	FBN1+ FIB
S14_GTAGTCAAGATGTGGC	FBN1+ FIB
S14_TACTCGCCAGGATTGG	APOE+ FIB
S14_ACTTACTGTTGGAGGT	APOE+ FIB
S14_CTCCTAGGTACGCACC	FBN1+ FIB
S14_ATGGGAGTCTAACTGG	APOE+ FIB
S14_AGATCTGTCCGCGGTA	FBN1+ FIB
S14_TGTGTTTTCCTAGTGA	Inflam. FIB
S14_GATGCTACATGTCGAT	FBN1+ FIB
S14_TGGGCGTGTTATGTGC	APOE+ FIB
S14_TAGCCGGTCGGAAACG	FBN1+ FIB
S14_ACTGTCCCAGAAGCAC	COL11A1+ FIB
S14_AGATCTGGTCAGAGGT	APOE+ FIB
S14_AAATGCCGTGTCCTCT	APOE+ FIB
S14_AGGGATGCAAGCGTAG	APOE+ FIB
S14_TCAGATGTCAGCGATT	APOE+ FIB
S14_AACTGGTAGAAACGAG	APOE+ FIB
S14_CCTACCAAGCGCTCCA	FBN1+ FIB
S14_GGATGTTCATTGAGCT	APOE+ FIB
S14_CGTCAGGGTCGCGAAA	APOE+ FIB
S14_CCTACCATCGGAATCT	APOE+ FIB
S14_ATCACGATCCGTCATC	APOE+ FIB
S14_GTATCTTAGTGACTCT	FBN1+ FIB
S14_CTCAGAAAGAGTACAT	APOE+ FIB
S14_TACGGATTCGGAGGTA	APOE+ FIB
S14_AGGTCATCAGATGGGT	APOE+ FIB
S14_CAAGAAACAGGATCGA	APOE+ FIB
S14_CTCGAAAAGCTAGTTC	FBN1+ FIB
S14_TAGTGGTCAGGTCGTC	APOE+ FIB
S14_GGGCACTAGTCGCCGT	FBN1+ FIB
S14_CCATTCGGTCCTGCTT	FBN1+ FIB
S14_CGTGAGCTCAGTGCAT	APOE+ FIB
S14_GGGTCTGAGACAGACC	APOE+ FIB
S14_TCACGAACAAAGGCGT	Inflam. FIB
S14_CTTGGCTGTCCTCTTG	APOE+ FIB
S14_GATTCAGGTGCTTCTC	FBN1+ FIB
S14_CCTATTAGTCACTTCC	APOE+ FIB
S14_CTGATAGGTGGCCCTA	FBN1+ FIB
S14_GTAGTCAAGTGGTAAT	APOE+ FIB
S14_CGTAGCGGTTAAAGTG	FBN1+ FIB
S14_TACTTGTGTATGGTTC	COL11A1+ FIB
S14_AAACCTGAGACTAGGC	APOE+ FIB
S14_TGAAAGACATACGCCG	APOE+ FIB
S14_GAACGGATCTTGTACT	Inflam. FIB
S14_TGATTTCTCAGCTTAG	APOE+ FIB
S14_AGCGTCGCATTAACCG	FBN1+ FIB
S14_CAACTAGGTCTAGCCG	FBN1+ FIB
S14_ATGTGTGCACGGATAG	APOE+ FIB
S14_TTTGCGCTCTTGTCAT	APOE+ FIB
S14_ATTGGACTCCTTTCGG	APOE+ FIB
S14_CTACATTTCCCAACGG	APOE+ FIB
S14_TAAGCGTGTAGCAAAT	APOE+ FIB
S14_ATCTGCCGTCAGAAGC	APOE+ FIB
S14_ACCAGTAGTTAGGGTG	APOE+ FIB
S14_AGCCTAACAATAACGA	APOE+ FIB
S14_AGCGTCGAGCCGATTT	APOE+ FIB
S14_TTTGGTTGTAGAAGGA	APOE+ FIB
S14_TTGAACGCAATTCCTT	APOE+ FIB
S14_GAACGGACAACTGCGC	APOE+ FIB
S14_CTCCTAGCAATGTTGC	APOE+ FIB
S14_CGTGTCTAGTAGATGT	Inflam. FIB
S14_TGGACGCCAATACGCT	FBN1+ FIB
S14_AGCGGTCGTGCACGAA	APOE+ FIB
S14_GTACTCCCAGACGCCT	APOE+ FIB
S14_AGTGTCACACGGTTTA	APOE+ FIB
S14_GCACATACAACGCACC	FBN1+ FIB
S14_AGAATAGCAATAGCGG	APOE+ FIB
S14_GGGCACTAGGCCCTTG	APOE+ FIB
S14_GCGACCAAGATAGGAG	APOE+ FIB
S14_CGTAGCGGTGTGGTTT	APOE+ FIB
S14_CCGTGGAAGGCAATTA	FBN1+ FIB
S14_GGTGTTATCTGTCTAT	APOE+ FIB
S14_ACTGCTCAGATACACA	FBN1+ FIB
S14_AGCATACGTCAAGCGA	APOE+ FIB
S14_GAAATGAAGGCTAGGT	FBN1+ FIB
S14_TTTATGCCAAGAGGCT	FBN1+ FIB
S14_TCAACGAGTCTAACGT	APOE+ FIB
S14_TTAGGCAAGTCAATAG	COL11A1+ FIB
S14_GACACGCGTGAGGCTA	APOE+ FIB
S14_TCACAAGAGCGCTTAT	APOE+ FIB
S14_ACATCAGAGACTAGAT	APOE+ FIB
S14_CGTGTCTTCCCAACGG	APOE+ FIB
S14_CATCAGACATAGGATA	APOE+ FIB
S14_GTTCGGGGTCCAAGTT	APOE+ FIB
S14_CTTACCGTCTGCAAGT	APOE+ FIB
S14_ACGGGCTAGCTAACAA	APOE+ FIB
S14_GCAATCATCTATCCCG	FBN1+ FIB
S14_GGCGACTTCAGCATGT	APOE+ FIB
S14_CAGCCGAAGCACACAG	APOE+ FIB
S14_CCGTGGACAGCGTCCA	APOE+ FIB
S14_TTTATGCCAGTGAGTG	APOE+ FIB
S14_CAGCTAATCGTTACGA	APOE+ FIB
S14_CTAGAGTAGACTTTCG	COL11A1+ FIB
S14_CGTCTACCAGCGTCCA	APOE+ FIB
S14_CATCCACTCTCACATT	APOE+ FIB
S14_GGATTACAGGCGTACA	APOE+ FIB
S14_ATCATGGGTGCAACTT	APOE+ FIB
S14_GGGATGAGTCATCGGC	COL11A1+ FIB
S14_TACCTTATCACCGGGT	FBN1+ FIB
S14_TGTGTTTCAGTTCATG	APOE+ FIB
S14_CAAGAAATCATTCACT	APOE+ FIB
S14_CTCATTATCTAGAGTC	APOE+ FIB
S14_TGACGGCTCGTTTGCC	APOE+ FIB
S14_CACACTCCAAAGCAAT	APOE+ FIB
S14_AAATGCCGTCGCTTTC	FBN1+ FIB
S14_GACCAATAGAGGGATA	APOE+ FIB
S14_GCATACACAACTGCTA	APOE+ FIB
S14_CATCGAACAATCGGTT	APOE+ FIB
S14_CCGTACTAGTCCCACG	APOE+ FIB
S14_TGTTCCGCACATGACT	APOE+ FIB
S14_GATCGATCATGCTAGT	APOE+ FIB
S14_AGCGGTCAGCTGAAAT	Inflam. FIB
S14_GTCGTAAAGTGGTCCC	FBN1+ FIB
S14_GACCAATAGTCTCCTC	FBN1+ FIB
S14_CTAACTTAGCTATGCT	FBN1+ FIB
S14_AATCGGTAGTGCGATG	APOE+ FIB
S14_CGACCTTCAAACTGTC	APOE+ FIB
S14_GGACGTCAGATCTGAA	APOE+ FIB
S14_ACTTTCAAGCCTATGT	APOE+ FIB
S14_GGGAGATGTAGGGACT	APOE+ FIB
S14_AACTCCAGTTATTCTC	APOE+ FIB
S14_CATCCACGTATCAGTC	APOE+ FIB
S14_GTGCATAAGCCCAACC	APOE+ FIB
S14_ATTGGACTCAGCATGT	APOE+ FIB
S14_GTAGGCCACCCTATCT	APOE+ FIB
S14_GTAGGCCACCCTATCC	APOE+ FIB
S14_GTAGGCCACCCTATCA	APOE+ FIB
S14_AGCGTATCAGTTCCCT	FBN1+ FIB
S15_GCTGCAGCATGCCTTC	FBN1+ FIB
S15_ATAGACCTCAACACTG	FBN1+ FIB
S15_GGGACCTCACGACGAA	FBN1+ FIB
S15_AACGTTGTCAACACCA	FBN1+ FIB
S15_TCAACGAGTGCGATAG	FBN1+ FIB
S15_CTCGGAGGTGCCTGCA	FBN1+ FIB
S15_CTAATGGAGTCGAGTG	FBN1+ FIB
S15_ACACTGACAACAACCT	FBN1+ FIB
S15_GCTTGAAAGATCCGAG	FBN1+ FIB
S15_CAGCTAAAGACAATAC	FBN1+ FIB
S15_TGCCCATGTCGTTGTA	FBN1+ FIB
S15_TGCCCTAAGTACACCT	APOE+ FIB
S15_CTCTAATTCTCCCTGA	FBN1+ FIB
S15_TGCTACCGTGCAGGTA	COL11A1+ FIB
S15_CGTGTCTTCAGGTAAA	FBN1+ FIB
S15_GACTAACAGGAACTGC	APOE+ FIB
S15_AGCTCCTGTGACGCCT	FBN1+ FIB
S15_GATCGCGGTATGGTTC	FBN1+ FIB
S15_GATCGTAGTCTCACCT	FBN1+ FIB
S15_ATTGGACAGCCTTGAT	FBN1+ FIB
S15_GTGCATATCGCATGGC	FBN1+ FIB
S15_GGTGTTAGTGGGTATG	FBN1+ FIB
S15_GGGAATGCATAGACTC	APOE+ FIB
S15_GTCAAGTTCGAACGGA	FBN1+ FIB
S15_ATCCACCAGTGTACTC	FBN1+ FIB
S15_AATCCAGCAATAGAGT	APOE+ FIB
S15_CAGGTGCTCTATGTGG	FBN1+ FIB
S15_GCAATCATCAGTACGT	FBN1+ FIB
S15_CGTCAGGCACGTTGGC	FBN1+ FIB
S15_CAACCTCAGCTAACTC	Inflam. FIB
S15_CAGCTAAAGCTAGTCT	FBN1+ FIB
S15_CAGCCGACAACGATCT	APOE+ FIB
S15_AGTGGGAAGGCTAGAC	APOE+ FIB
S15_ACGGCCAAGATCCTGT	APOE+ FIB
S15_TCTCATACAGACGCCT	FBN1+ FIB
S15_CCCAATCCAACTGCGC	FBN1+ FIB
S15_ACGCCAGCATCATCCC	Inflam. FIB
S15_TGCCCTATCTGTGCAA	COL11A1+ FIB
S15_AGGTCATTCCTAAGTG	FBN1+ FIB
S15_TCAGCTCCACCGATAT	FBN1+ FIB
S15_CGTCACTAGACAGGCT	Inflam. FIB
S15_GACTAACTCCCTAATT	FBN1+ FIB
S15_CCAATCCTCTCGATGA	FBN1+ FIB
S15_AGAGCGACAAGGACTG	COL11A1+ FIB
S15_GACTACACAGTCAGCC	FBN1+ FIB
S15_CAGTCCTAGGTTACCT	FBN1+ FIB
S15_CTAGCCTTCCGCATCT	APOE+ FIB
S15_TGTGGTAGTTGATTGC	APOE+ FIB
S15_TGCGGGTTCCACGTTC	Inflam. FIB
S15_TAGTGGTCACGAAAGC	FBN1+ FIB
S15_TTGGCAAGTTATTCTC	Inflam. FIB
S15_GGGACCTGTCTTCAAG	COL11A1+ FIB
S15_CACTCCATCTAGCACA	APOE+ FIB
S15_ACACCGGAGCAATATG	FBN1+ FIB
S15_CTTAGGAGTCCCTTGT	FBN1+ FIB
S15_CTCATTAAGATTACCC	FBN1+ FIB
S15_TAGGCATCAGACGCTC	APOE+ FIB
S15_TACCTATGTTGTCTTT	APOE+ FIB
S15_TTCTCAATCGTTTATC	APOE+ FIB
S15_AATCGGTTCCTTGGTC	APOE+ FIB
S15_ACCCACTAGTATTGGA	Inflam. FIB
S15_TAGACCATCCGAGCCA	FBN1+ FIB
S15_TGGCCAGAGGGATCTG	APOE+ FIB
S15_TATTACCCAGGTGCCT	FBN1+ FIB
S15_CCTTCGAAGCCCTAAT	APOE+ FIB
S15_CGGTTAACAGGCAGTA	FBN1+ FIB
S15_CAGCAGCAGGAGTCTG	APOE+ FIB
S15_GGTGCGTCATACGCTA	APOE+ FIB
S15_ACTGAGTCAACAACCT	FBN1+ FIB
S15_AAGGAGCTCCGCGTTT	APOE+ FIB
S15_AGAGCTTGTCTCGTTC	Inflam. FIB
S15_GATCTAGCATGCCCGA	FBN1+ FIB
S15_CTACATTCAAACTGCT	APOE+ FIB
S15_CTCACACCATGTTGAC	FBN1+ FIB
S15_TGGCGCAAGGCTCTTA	FBN1+ FIB
S15_GGGCATCAGTTAGCGG	APOE+ FIB
S15_GCACTCTGTAATCACC	COL11A1+ FIB
S15_TAGCCGGGTACTCGCG	APOE+ FIB
S15_ATCTGCCGTCAAAGCG	APOE+ FIB
S15_CGTCAGGTCTTAGCCC	APOE+ FIB
S15_CTGCTGTTCCAAACTG	APOE+ FIB
S15_AGTAGTCCAATGACCT	FBN1+ FIB
S15_TCGCGAGGTAGCGCTC	APOE+ FIB
S15_CCTAGCTAGGCAATTA	APOE+ FIB
S15_TGCGTGGAGAGTTGGC	FBN1+ FIB
S15_ACCCACTGTTTAGGAA	APOE+ FIB
S15_TCACAAGTCAGTCCCT	APOE+ FIB
S15_TAAGAGATCCTCAATT	APOE+ FIB
S15_CATCGAAGTTCAGGCC	FBN1+ FIB
S15_ATTACTCAGGTTCCTA	FBN1+ FIB
S15_AAGGCAGCAGTCACTA	FBN1+ FIB
S15_TAGTTGGAGGTGACCA	APOE+ FIB
S15_TATTACCCATGTCTCC	FBN1+ FIB
S15_ACTGATGAGTACGCCC	FBN1+ FIB
S15_AGACGTTAGGAGTTTA	APOE+ FIB
S15_TCTCATAAGTCTCAAC	FBN1+ FIB
S15_CCACCTAAGTACGTAA	FBN1+ FIB
S15_CTAATGGCAGGTGCCT	APOE+ FIB
S15_AATCCAGAGAAGCCCA	FBN1+ FIB
S15_CGACCTTAGTTAAGTG	APOE+ FIB
S15_ACATACGGTCATACTG	Inflam. FIB
S15_AGTGGGACAACGATGG	APOE+ FIB
S15_TTGCCGTCAGATGGGT	APOE+ FIB
S15_GGACGTCAGAGGGCTT	APOE+ FIB
S15_AACCGCGTCTGTACGA	APOE+ FIB
S15_GTGCTTCGTTAAGACA	COL11A1+ FIB
S15_TAGTTGGGTTCCGGCA	FBN1+ FIB
S15_TCAGGATCATGCAACT	FBN1+ FIB
S15_CGTCAGGAGAGAACAG	APOE+ FIB
S15_CTAATGGCAGTTCCCT	FBN1+ FIB
S15_AGGCCACCAAGTCTAC	FBN1+ FIB
S15_CTGCCTACAGAGTGTG	COL11A1+ FIB
S15_ACGCCAGTCGTCCAGG	APOE+ FIB
S15_CCGTTCATCGTAGGAG	FBN1+ FIB
S15_TGGACGCCAACTTGAC	APOE+ FIB
S15_AACTCTTTCAACGAAA	FBN1+ FIB
S15_CCGTACTCATGAGCGA	COL11A1+ FIB
S15_TTCTCAAAGAAACCAT	APOE+ FIB
S15_CTAACTTCAGGGCATA	APOE+ FIB
S15_GCACTCTAGGGTCGAT	Inflam. FIB
S15_AGCAGCCCAGGCGATA	COL11A1+ FIB
S15_ACAGCTATCGCGTTTC	COL11A1+ FIB
S15_CGGGTCATCGTCTGCT	FBN1+ FIB
S15_ACTGTCCTCTTCAACT	FBN1+ FIB
S15_AGAGCGAGTAGGGTAC	APOE+ FIB
S15_CGCCAAGTCACCACCT	COL11A1+ FIB
S15_GGCGACTAGTACGCCC	APOE+ FIB
S15_CGGAGTCTCTGCAAGT	APOE+ FIB
S15_TTGCCGTCACTGTGTA	FBN1+ FIB
S15_AGTGTCATCTTGTACT	APOE+ FIB
S15_TCGCGAGAGCCTTGAT	APOE+ FIB
S15_CCTCTGACACCCTATC	APOE+ FIB
S15_CATCGAAGTCTGCAAT	APOE+ FIB
S15_ATAAGAGCAGGGCATA	FBN1+ FIB
S15_CTTACCGCACACATGT	APOE+ FIB
S15_ATCTGCCGTCTTGCGG	Inflam. FIB
S15_TGAGCATCAAGTACCT	APOE+ FIB
S15_TTCGAAGTCCTTGACC	APOE+ FIB
S15_ACGGAGAAGACAAGCC	Inflam. FIB
S15_CCGTACTCAAACCCAT	FBN1+ FIB
S15_TCAGATGAGGCCGAAT	APOE+ FIB
S15_GAATGAAGTAGGCTGA	FBN1+ FIB
S15_AGCAGCCCACTGTTAG	APOE+ FIB
S15_CTAACTTCACCTCGGA	FBN1+ FIB
S15_TGAGCCGTCTGTGCAA	APOE+ FIB
S15_ATTTCTGCAAGCTGTT	FBN1+ FIB
S15_TGGGCGTCAATCCGAT	APOE+ FIB
S15_TAGGCATCACGAGGTA	FBN1+ FIB
S15_AGGGATGGTTACTGAC	FBN1+ FIB
S15_ACCCACTGTCCGTGAC	COL11A1+ FIB
S15_GCATGTAAGGCATGGT	FBN1+ FIB
S15_TCGGTAAAGCAAATCA	APOE+ FIB
S15_ACACCCTCACAGTCGC	FBN1+ FIB
S15_CTAATGGGTACAGACG	APOE+ FIB
S15_CTGAAGTTCACCTTAT	APOE+ FIB
S15_ATGGGAGCATGCCACG	FBN1+ FIB
S15_TCGCGAGTCGTGGGAA	FBN1+ FIB
S15_CCGTTCAGTAAATGAC	COL11A1+ FIB
S15_CGGACACTCTGTTGAG	FBN1+ FIB
S15_GTGCATAAGGCTCTTA	APOE+ FIB
S15_ATCGAGTCACGGCTAC	APOE+ FIB
S15_GTACTTTCATGCAATC	FBN1+ FIB
S15_ACTTGTTCAGTATAAG	APOE+ FIB
S15_ACGTCAACAGGGTACA	FBN1+ FIB
S15_GGAGCAATCAAGATCC	FBN1+ FIB
S15_GTGCTTCGTTCATGGT	APOE+ FIB
S15_AACTCTTAGGTGGGTT	APOE+ FIB
S15_TCATTACAGGACATTA	APOE+ FIB
S15_TTCTACACAATCTGCA	APOE+ FIB
S15_TGATTTCAGAAACGAG	Inflam. FIB
S15_CTCGTCAAGGAGTTGC	APOE+ FIB
S15_TTCTCCTAGGATTCGG	FBN1+ FIB
S15_TTGGCAACATGCTGGC	APOE+ FIB
S15_ATAACGCTCCTCCTAG	APOE+ FIB
S15_GCAGTTATCTTTAGGG	APOE+ FIB
S15_GTTACAGTCACGGTTA	APOE+ FIB
S15_TTCGGTCTCGCCCTTA	APOE+ FIB
S15_GCTCTGTAGTGGTAGC	FBN1+ FIB
S15_GCTTCCATCAGCTCTC	COL11A1+ FIB
S15_TTCTTAGTCACGCGGT	FBN1+ FIB
S15_ACACCCTTCATCACCC	APOE+ FIB
S15_AAATGCCGTGGTAACG	APOE+ FIB
S15_CGAGCACTCATCACCC	COL11A1+ FIB
S15_CGAATGTAGAAGGCCT	FBN1+ FIB
S15_GTAGTCATCCGTCAAA	FBN1+ FIB
S15_TCAGGTACACCGAATT	APOE+ FIB
S15_CGGACTGGTTCGCGAC	Inflam. FIB
S15_TTTACTGAGGATGGTC	APOE+ FIB
S15_ATCATGGAGCACCGCT	FBN1+ FIB
S15_CGTTCTGAGAATGTTG	Inflam. FIB
S15_TACGGGCTCCTAGAAC	APOE+ FIB
S15_ATTGGACCATTCGACA	APOE+ FIB
S15_TGGGAAGTCTGTCTAT	FBN1+ FIB
S15_AATCGGTAGCTTCGCG	APOE+ FIB
S15_CTCATTATCACAGTAC	APOE+ FIB
S15_GGTGAAGCAATAGCGG	FBN1+ FIB
S15_CCAGCGAAGAATGTGT	APOE+ FIB
S15_GAACATCTCGTAGATC	COL11A1+ FIB
S15_ACATCAGAGGTGCTAG	APOE+ FIB
S15_AAACGGGTCCGCGCAA	APOE+ FIB
S15_GAAACTCGTCTCGTTC	APOE+ FIB
S15_TCTTTCCCACAGCGTC	APOE+ FIB
S15_TGCGGGTGTGGTAACG	APOE+ FIB
S15_ACGAGCCGTTGTACAC	Inflam. FIB
S15_TTGGAACTCGAACGGA	APOE+ FIB
S15_AGGGAGTGTCATTAGC	APOE+ FIB
S15_GTTCGGGCAGACGCCT	FBN1+ FIB
S15_CATCGAAAGGAGTTTA	FBN1+ FIB
S15_CGTAGGCTCACCCGAG	APOE+ FIB
S15_TCACGAACATAACCTG	APOE+ FIB
S15_CGGAGTCAGAGTGACC	FBN1+ FIB
S15_ACGCCGAGTTCCACTC	COL11A1+ FIB
S15_TCGTACCTCGGCGCAT	COL11A1+ FIB
S15_CTACGTCAGTACGTAA	FBN1+ FIB
S15_CGCTTCATCTGCTGTC	COL11A1+ FIB
S15_TAGACCACATCGATGT	APOE+ FIB
S15_CAACTAGTCAACTCTT	APOE+ FIB
S15_CTGCCTAGTAGAGCTG	FBN1+ FIB
S15_ATGGGAGCACCTCGTT	APOE+ FIB
S15_CTAATGGCAAAGCGGT	APOE+ FIB
S15_ACAGCTAGTCTCCCTA	Inflam. FIB
S15_CCCAGTTTCTTAGCCC	APOE+ FIB
S15_GCTTGAATCAGGATCT	APOE+ FIB
S15_CTAAGACTCACATACG	APOE+ FIB
S15_GGTGAAGGTTCTGAAC	APOE+ FIB
S15_ACTGAACGTGCGGTAA	APOE+ FIB
S15_ATAACGCTCCGCGGTA	APOE+ FIB
S15_GTCATTTGTCAACATC	FBN1+ FIB
S15_GCATGATAGAGTGAGA	COL11A1+ FIB
S15_ACGATACTCTTTAGTC	FBN1+ FIB
S15_GTACTTTCAGCGATCC	APOE+ FIB
S15_TCGAGGCTCTGTTTGT	APOE+ FIB
S15_CGCGGTAGTCATACTG	APOE+ FIB
S15_CGTGTAATCACTCCTG	FBN1+ FIB
S15_ATCGAGTGTGATAAAC	APOE+ FIB
S15_ACCTTTACAGGATTGG	FBN1+ FIB
S15_CATGACAAGGGAAACA	COL11A1+ FIB
S15_AACTTTCGTTGGAGGT	APOE+ FIB
S15_TTGAACGAGGTGCTTT	APOE+ FIB
S15_TCAGGTAGTGCTCTTC	APOE+ FIB
S15_CATATTCGTCGCGAAA	APOE+ FIB
S15_TACTCATCATAGTAAG	APOE+ FIB
S15_GTGAAGGAGTGCGATG	FBN1+ FIB
S15_GTGAAGGCAAGCCCAC	APOE+ FIB
S15_AACCATGGTGTTTGGT	APOE+ FIB
S15_CTCCTAGAGCCGGTAA	COL11A1+ FIB
S15_GGAACTTGTCTAGTGT	APOE+ FIB
S15_CATTCGCTCGTCCGTT	FBN1+ FIB
S15_TTGCCGTGTAAGTGGC	APOE+ FIB
S15_CAGAGAGCATGGTTGT	FBN1+ FIB
S15_GTGCAGCTCGTCGTTC	COL11A1+ FIB
S15_GCTGCGAGTAGCCTCG	APOE+ FIB
S15_TGGACGCGTTCGGGCT	FBN1+ FIB
S15_CGAGAAGTCGTGGTCG	FBN1+ FIB
S15_ATGTGTGAGTGACTCT	FBN1+ FIB
S15_CGCGTTTGTTCCATGA	APOE+ FIB
S15_ACGCAGCAGTATCGAA	FBN1+ FIB
S15_GTTAAGCAGCGTAGTG	APOE+ FIB
S15_TGATTTCCACCTATCC	APOE+ FIB
S15_CTCTACGAGACTACAA	APOE+ FIB
S15_ACCTTTAGTTGAGGTG	FBN1+ FIB
S15_GTTAAGCTCTTCGGTC	FBN1+ FIB
S15_GCTCTGTTCTTACCGC	COL11A1+ FIB
S15_TTGGCAAAGAAACCTA	APOE+ FIB
S15_ATAAGAGAGTGGAGAA	APOE+ FIB
S15_AGCTCCTGTTACTGAC	COL11A1+ FIB
S15_CACAGTACATCCCATC	APOE+ FIB
S15_ATCCGAAAGTCTCGGC	APOE+ FIB
S15_CTGAAGTCATACCATG	APOE+ FIB
S15_ACTGCTCAGGCCCGTT	APOE+ FIB
S15_ATCTACTAGTCGTACT	FBN1+ FIB
S15_TTTATGCTCTTGAGGT	FBN1+ FIB
S3_ACGAGGAAGTCATCCA	LC
S3_CAGAGAGTCGCTAGCG	LC
S3_GGGACCTTCCGAGCCA	cDC2
S3_CATCAGATCCTAGAAC	cDC1
S3_GGATGTTCATCCTTGC	cDC2
S3_GGACAAGCATACGCCG	cDC2
S3_TGAGGGACATTGCGGC	cDC2
S3_ACGAGCCGTAGCGCTC	LC
S3_ACCCACTTCTCGGACG	LC
S3_CACATAGGTCCGTTAA	cDC2
S3_CGAATGTTCATTGCGA	cDC2
S3_CATCGGGAGTGTGAAT	cDC2
S3_GCTGGGTCAAAGAATC	LC
S3_TTGGAACAGAAACGAG	cDC2
S3_GGCTCGAAGTCATGCT	cDC2
S3_CCGGGATTCTCACATT	cDC2
S3_CGAATGTTCCAAATGC	cDC1
S3_CCGGGATAGCGTAGTG	cDC2
S3_CCGTACTCACCCTATC	cDC1
S3_AGCAGCCCATGCAACT	cDC1
S3_TTATGCTGTAGGACAC	LC
S3_AGTTGGTTCTATCGCC	cDC2
S3_GATCGTAGTTGTGGCC	cDC1
S3_GCATGCGCACTTACGA	cDC2
S11_GCTCCTAGTCCCTTGT	cDC2
S11_CTTTGCGGTCCATGAT	cDC2
S11_TGGGAAGAGGTAAACT	cDC2
S14_CAGCTGGCATTCCTCG	LC
S14_GTCCTCAAGCGTAGTG	cDC2
S14_CCAGCGATCAACACAC	cDC2
S14_TGGCGCACACGAGAGT	LC
S14_GCTGCGATCAAGATCC	Inflam. DC
S14_GAAATGACAAGAAAGG	cDC2
S14_TGCTGCTGTTCCATGA	cDC2
S14_CATATTCCACGCGAAA	LC
S14_CAGCTGGTCACTTATC	cDC1
S14_GGCGTGTGTTCCATGA	LC
S14_GAGGTGACATAAGACA	cDC2
S14_TACTTACCATATGCTG	LC
S14_GGACAGATCCGTAGTA	cDC2
S14_TCTATTGAGTTAAGTG	cDC2
S14_ACTGTCCGTAGCTCCG	cDC2
S14_ATTGGACTCTGCTTGC	cDC1
S14_ACTGAGTAGAGACTTA	LC
S14_CACAGGCAGGGATGGG	cDC2
S14_GTCGTAACAGCGTAAG	LC
S14_CATGACAGTTGATTGC	LC
S14_TGAAAGACAAGGTTTC	cDC2
S14_TCACGAACAGCTGGCT	cDC2
S14_TTCTTAGTCTCTGCTG	cDC2
S14_GTCTCGTAGCTACCTA	LC
S14_CGTGTCTGTTCGCGAC	LC
S14_CATATTCTCTTTAGTC	cDC2
S14_ATTACTCTCACTCTTA	cDC2
S14_GGGTTGCTCTACCTGC	LC
S14_GCTGCTTTCATGTAGC	cDC2
S14_TCTCATATCGATAGAA	cDC2
S14_CACATTTAGAAACGAG	cDC2
S15_CTGTTTAAGGAATTAC	cDC2
S15_CACTCCAGTAGGAGTC	LC
S15_ACGAGGATCGAATCCA	LC
S15_CACTCCAAGCCGCCTA	cDC2
S15_AGGCCACGTATATCCG	LC
S15_CGGGTCAGTCACCCAG	cDC2
S15_TTGCGTCAGCATGGCA	cDC2
S15_TTCTTAGTCTAGCACA	cDC2
S3_TCACGAATCTGCAAGT	Inflam. TC
S3_CTGAAGTAGTCGAGTG	Inflam. TC
S3_CCTTACGCAGCTCGAC	Inflam. TC
S3_AATCCAGAGGGATCTG	NKT
S3_AACCGCGCAGAGCCAA	CD40LG+ TC
S3_AAAGATGCATCGATGT	Inflam. TC
S3_GTATTCTGTACCAGTT	CD40LG+ TC
S3_ACGTCAAAGTGATCGG	CD40LG+ TC
S3_GGAAAGCTCAGGCCCA	CD40LG+ TC
S3_GGGAATGCAAGTCTAC	NKT
S3_GATCGCGAGACAATAC	CD40LG+ TC
S3_AGTGAGGTCAGAAATG	CD40LG+ TC
S3_CAGATCAAGACTAGAT	TC
S3_ACGGCCACACATGTGT	NKT
S3_CTGAAGTCAATCCGAT	Inflam. TC
S3_AACTGGTTCGATGAGG	CD40LG+ TC
S3_TGACAACCAAGAGTCG	CD40LG+ TC
S3_TCTCTAATCTAAGCCA	TC
S3_CAAGATCCATGGATGG	Inflam. TC
S3_AACCATGTCCCTTGCA	CD40LG+ TC
S3_AGTTGGTAGCCCAGCT	Inflam. TC
S3_TAAGCGTAGAGTACCG	Inflam. TC
S3_GTACTCCGTTGGTAAA	CD40LG+ TC
S3_CCTAAAGAGTCGATAA	CD40LG+ TC
S3_CGGTTAATCGGCTTGG	CD40LG+ TC
S3_GTGGGTCTCATTCACT	CD40LG+ TC
S3_CGTTCTGTCCACTGGG	CD40LG+ TC
S3_TTATGCTCAACACCTA	CD40LG+ TC
S3_CGTCCATAGGCTACGA	Inflam. TC
S3_CACATAGAGCTCCCAG	TC
S3_CATTATCCAGCCTATA	CD40LG+ TC
S3_GCATACAAGCCAGTTT	CD40LG+ TC
S3_CGCTATCCAGTAGAGC	TC
S3_CATCCACAGATCGGGT	CD40LG+ TC
S3_CCGGTAGGTCACCCAG	TC
S3_CTCGAGGTCCTAGGGC	CD40LG+ TC
S3_GCATGATGTGCATCTA	CD40LG+ TC
S3_ATTCTACCACAACTGT	CD40LG+ TC
S3_TTATGCTCAAGTCTAC	TC
S3_CGTCAGGTCACCCGAG	NKT
S3_TTCTACATCTGCTTGC	CD40LG+ TC
S3_AAGACCTAGGATTCGG	Inflam. TC
S3_AATCCAGTCACCACCT	CD40LG+ TC
S3_CGTTCTGCAAGTACCT	CD40LG+ TC
S3_GACACGCTCCACGTGG	TC
S3_GCATGATAGACAATAC	CD40LG+ TC
S3_GACAGAGTCTTGACGA	CD40LG+ TC
S3_GGGTTGCTCGACCAGC	Inflam. TC
S3_TACGGATCAGGTCCAC	CD40LG+ TC
S3_GTAGGCCGTCTTGCGG	CD40LG+ TC
S3_GGCTGGTGTGAAAGAG	NKT
S3_ACTTACTTCCATGAAC	CD40LG+ TC
S3_GTTAAGCCACGACTCG	CD40LG+ TC
S3_CTCACACCAGTCAGCC	CD40LG+ TC
S3_CACAGTATCACATACG	CD40LG+ TC
S3_TGAAAGAGTAGCGTCC	CD40LG+ TC
S3_CTAGCCTAGCAATCTC	TC
S3_CTCGGAGTCAAGCCTA	CD40LG+ TC
S3_TGCGGGTCACTTACGA	TC
S3_TTTCCTCGTACTCAAC	CD40LG+ TC
S3_GCTTGAAAGCTGAACG	TC
S3_AGATTGCTCGGCGCTA	CD40LG+ TC
S3_CGGTTAATCCCATTAT	Inflam. TC
S3_ACTGATGAGCACGCCT	TC
S3_CCTATTAAGCTTTGGT	TC
S3_AGTAGTCTCTGCGGCA	CD40LG+ TC
S3_CACACAAAGCTTATCG	TC
S3_CGTCCATCATGAACCT	CD40LG+ TC
S3_CCGTACTTCTACTATC	TC
S3_GTCATTTCACCTATCC	TC
S3_CGCTATCTCTCTAGGA	TC
S3_CCTACCATCACCAGGC	CD40LG+ TC
S3_GATGCTAGTGTGAAAT	TC
S3_TAAGCGTGTGAGGCTA	CD40LG+ TC
S3_CTCATTACACAAGCCC	CD40LG+ TC
S3_AAGCCGCCACTTACGA	CD40LG+ TC
S3_CTCACACTCGTACCGG	CD40LG+ TC
S3_TACAGTGTCGTAGGTT	Inflam. TC
S3_AGATTGCTCTGTCTCG	TC
S3_TTTATGCCAGTGACAG	Inflam. TC
S3_AGCTTGACAAGAAAGG	CD40LG+ TC
S3_AGTGTCACAGTATCTG	CD40LG+ TC
S3_CTGTGCTGTCGATTGT	TC
S3_TTTGTCATCACCACCT	NKT
S3_CACACTCTCGTAGGTT	CD40LG+ TC
S3_AAAGATGTCGCGATCG	CD40LG+ TC
S3_CCTTCCCGTGGTTTCA	TC
S3_GTGCAGCTCGGCCGAT	CD40LG+ TC
S3_GTACTTTTCAGAGGTG	CD40LG+ TC
S3_GTACTCCTCATGGTCA	CD40LG+ TC
S3_GGTATTGAGGCCATAG	TC
S3_AGCTCTCTCTTACCTA	TC
S3_TAAACCGAGCTGTCTA	TC
S3_TGGGAAGAGTGACTCT	CD40LG+ TC
S3_CATCAAGTCCAGATCA	NKT
S3_TTAGTTCTCATTGCGA	TC
S3_ATGTGTGAGGTTCCTA	TC
S3_CCATGTCCAAATTGCC	CD40LG+ TC
S3_ACGCAGCGTTATCACG	CD40LG+ TC
S3_AACCATGTCGGCGGTT	TC
S3_AAAGTAGCAGGATCGA	CD40LG+ TC
S3_TCATTTGCACACGCTG	TC
S3_GTGAAGGGTCGCTTTC	CD40LG+ TC
S3_CTCCTAGGTTCGGCAC	CD40LG+ TC
S3_ATAACGCGTCCAAGTT	TC
S3_TGGTTCCAGACGACGT	CD40LG+ TC
S3_GCGCAACAGGACAGCT	TC
S3_GCGCGATTCTCTGAGA	CD40LG+ TC
S3_GGAATAAGTCAGAAGC	TC
S3_ATAGACCAGATCGATA	TC
S3_AGAATAGGTAAACGCG	TC
S3_AACTCCCTCGAATGGG	CD40LG+ TC
S3_TTTCCTCCAAACAACA	Inflam. TC
S3_CGTCACTGTCTAGTGT	CD40LG+ TC
S3_TTGGAACGTTAAGAAC	CD40LG+ TC
S3_CGCGTTTAGCTGATAA	CD40LG+ TC
S3_TCAGATGCATACAGCT	NKT
S3_CCTCTGACACGACTCG	TC
S3_GCGCAACTCCCTTGCA	Inflam. TC
S3_ACCGTAAGTCTCAACA	TC
S3_GACTACAGTTCCCTTG	TC
S3_TAGTTGGAGGTAAACT	CD40LG+ TC
S3_AGCCTAAGTAGCGTAG	TC
S3_GACGGCTCAGTCACTA	CD40LG+ TC
S3_TTTGCGCTCCTTGGTC	TC
S3_TGTCCCAGTTCCGGCA	CD40LG+ TC
S3_ATCCGAACAATCGGTT	CD40LG+ TC
S3_TAAGTGCCAGCTGCAC	CD40LG+ TC
S3_CATGACACACTGAAGG	TC
S3_GTTTCTAGTGTTTGTG	Inflam. TC
S3_ACACCCTTCTGGTATG	CD40LG+ TC
S3_TGCGCAGTCGTACGGC	CD40LG+ TC
S3_CACATAGTCGAGAGCA	CD40LG+ TC
S3_TGTCCCAGTCGAGTTT	TC
S3_GCATGCGAGATGTTAG	CD40LG+ TC
S3_CGTCAGGGTCGACTGC	CD40LG+ TC
S3_GGTGAAGAGCGATTCT	TC
S3_TCATTTGGTACAGACG	Inflam. TC
S3_AACTCTTCATCCTAGA	CD40LG+ TC
S3_TGGCTGGCACGCTTTC	TC
S3_TGTCCCAGTTACAGAA	Inflam. TC
S3_TGTATTCTCGGACAAG	TC
S3_GAACATCAGTGAAGAG	CD40LG+ TC
S3_CGTCACTTCCAAATGC	TC
S3_AACGTTGAGTGCCAGA	CD40LG+ TC
S3_CCTAAAGAGCAATCTC	TC
S3_GACGCGTTCTTTACAC	TC
S3_TACCTTAGTTGCGCAC	Inflam. TC
S3_GGCGTGTTCTATGTGG	TC
S3_CCTTCGAAGATATGGT	Inflam. TC
S3_TGAGCATAGCGTCTAT	NKT
S3_AGCGTCGGTAAGTAGT	CD40LG+ TC
S3_ACCAGTAAGGAATTAC	TC
S3_CGCGGTAAGGAATCGC	TC
S3_CACCTTGGTAAACACA	CD40LG+ TC
S3_TTTGTCATCACTTATC	TC
S3_GTTTCTACACACATGT	TC
S3_GTACGTAAGGTACTCT	CD40LG+ TC
S3_TGGGAAGCACCCAGTG	CD40LG+ TC
S3_AGCGGTCAGGAGTCTG	CD40LG+ TC
S3_TTTATGCGTCTTGCGG	CD40LG+ TC
S3_CAGCGACAGTTTGCGT	CD40LG+ TC
S3_CGTGTCTTCGTCGTTC	Inflam. TC
S3_GTTTCTAGTACCGAGA	TC
S3_TGCCAAATCCTAAGTG	TC
S3_TCAGCTCTCGGCTACG	CD40LG+ TC
S3_ACATCAGCAACAACCT	CD40LG+ TC
S3_GTGCTTCGTCCAGTAT	TC
S3_ACGATGTGTCCCTTGT	TC
S3_ACTGATGAGGTGCAAC	Inflam. TC
S3_CTCTAATTCGGGAGTA	TC
S3_GACGGCTTCTCTTGAT	TC
S3_GAAACTCAGTATGACA	TC
S3_AAGTCTGCATGATCCA	TC
S3_CACCTTGTCTGGTATG	TC
S3_GGTGCGTCACACTGCG	Inflam. TC
S3_TGAGGGAGTTTAAGCC	CD40LG+ TC
S3_CCAATCCGTACATCCA	TC
S3_GTCGGGTGTTGGAGGT	CD40LG+ TC
S3_CTGATAGTCACCAGGC	TC
S3_TGACAACAGATCCCGC	CD40LG+ TC
S3_GCACTCTGTACAGTTC	CD40LG+ TC
S3_ACAGCCGAGCTAGTCT	CD40LG+ TC
S3_AGGTCATCAAAGAATC	CD40LG+ TC
S3_CTGTGCTAGAGGGATA	CD40LG+ TC
S3_GACTGCGTCACATGCA	CD40LG+ TC
S3_ATCGAGTTCCATGAAC	TC
S3_AGTCTTTAGAACAACT	TC
S3_CCACTACAGTTGCAGG	CD40LG+ TC
S3_CACATAGAGCACACAG	TC
S3_CAGATCACACGGTAGA	TC
S3_GCACATAAGATCACGG	TC
S3_TCTGAGAGTAAGTTCC	CD40LG+ TC
S3_ACCTTTAGTACGCTGC	TC
S3_GGAAAGCCAAGACACG	CD40LG+ TC
S3_ATTGGACCATGTCCTC	TC
S3_ACTTGTTCAGGTGCCT	Inflam. TC
S3_GCAATCAAGGTGGGTT	CD40LG+ TC
S3_TCACAAGCAGCTGTAT	CD40LG+ TC
S3_ACATCAGTCGGATGTT	TC
S3_CTGAAGTGTGCAGGTA	TC
S3_GCACTCTCATCGGGTC	TC
S3_TGCCCTAAGTGTGAAT	TC
S3_GCATACACAGATAATG	TC
S3_GAACCTACACTAAGTC	CD40LG+ TC
S3_CGACCTTCAGACAAGC	TC
S3_AGTTGGTTCACGACTA	CD40LG+ TC
S3_ACGGGTCAGAATTCCC	TC
S3_GCTGCGAAGCTAGGCA	TC
S3_GACGGCTTCCGCGTTT	TC
S3_GGGTCTGGTGAAGGCT	CD40LG+ TC
S3_CTGTGCTTCCTATGTT	TC
S3_AAGGCAGTCAGCTCGG	TC
S3_CTAGAGTAGATCTGAA	CD40LG+ TC
S3_CTTAGGACAGACGTAG	CD40LG+ TC
S3_ACAGCTATCGCGGATC	NKT
S3_TAGTGGTCAATACGCT	TC
S3_TTGAACGTCCACGACG	TC
S3_TCTGGAATCAGTTTGG	TC
S3_GTGTTAGGTAAAGGAG	TC
S3_GACTACAGTGCACCAC	NKT
S3_CTCACACGTGTTAAGA	TC
S3_TCTATTGTCGCGGATC	Inflam. TC
S3_TACAGTGAGCGATAGC	Inflam. TC
S3_TTTACTGCAAGTCTGT	TC
S3_CACCTTGTCAACCAAC	TC
S3_AGCTCTCTCACAGTAC	CD40LG+ TC
S3_CAAGAAACAGTATCTG	CD40LG+ TC
S3_GGACGTCCAGCGAACA	TC
S3_ATGAGGGCAGGTCGTC	TC
S3_TAAGAGAGTTCACGGC	TC
S3_GAGTCCGGTCCTGCTT	TC
S3_AATCGGTAGGAATTAC	Inflam. TC
S3_AAGTCTGAGGGATCTG	CD40LG+ TC
S3_CGGAGTCTCGAATGCT	TC
S3_CGTTCTGCACACATGT	TC
S3_CGACTTCGTAACGACG	TC
S3_GTGCAGCCATTGTGCA	TC
S3_AGCGTCGGTCGGCACT	TC
S3_AGTTGGTGTGAGTATA	Inflam. TC
S3_GGGCACTAGTGACATA	TC
S3_AGATTGCCAGATGAGC	TC
S3_GTTACAGGTCATTAGC	TC
S3_CCTACCAGTTCCGTCT	TC
S3_CCGGTAGGTAAGTGTA	TC
S3_GACTAACCACCTCGGA	TC
S3_AAAGTAGTCGTCTGAA	TC
S3_GACCTGGAGTGGTAGC	TC
S3_CTGGTCTAGTGGTAGC	TC
S3_ACAGCCGCAATAGCGG	TC
S3_GATCAGTGTACGCACC	TC
S3_AAGTCTGGTCACACGC	TC
S3_TTTCCTCAGGACTGGT	NKT
S3_CCGGGATAGTCGTTTG	TC
S3_CACTCCAGTTTGACTG	TC
S3_TGGGAAGTCAGTTAGC	TC
S3_CACACCTCATGCTAGT	TC
S3_CGTCACTGTCGACTAT	TC
S3_TCTCATAGTCTCCATC	Inflam. TC
S3_TCATTACTCCGTCAAA	TC
S3_GGCTCGAGTCGACTGC	TC
S3_ATCCGAATCGCCAAAT	TC
S3_AGCCTAACAGGAACGT	TC
S3_CCAGCGAGTAGCTCCG	TC
S3_AACGTTGCAACGCACC	TC
S3_GCAATCAAGTCAAGCG	TC
S3_GTCGTAATCATCACCC	TC
S3_AAACCTGAGCCAGAAC	Inflam. TC
S3_TTTGCGCCAGACAAAT	NKT
S3_CGAGAAGCACGCTTTC	CD40LG+ TC
S3_CTACCCACAAGAAAGG	TC
S3_GACTAACAGGGCTTCC	TC
S3_AGATCTGAGCCATCGC	TC
S3_TCAGGATGTCGCTTTC	TC
S3_CATGCCTGTTAAAGTG	TC
S3_CCTCAGTTCTCCAGGG	CD40LG+ TC
S3_TCTTTCCAGGCAGTCA	TC
S3_TTAGGACGTCACACGC	TC
S3_CCGTACTTCATCGCTC	TC
S3_TGTTCCGGTTGTCTTT	Inflam. TC
S3_CATCGAAAGAGGGCTT	TC
S3_CTGAAACAGAGCTGGT	TC
S3_CACTCCAGTCAACTGT	TC
S3_AGCGTCGGTGTAATGA	TC
S3_GAATGAACATGGTCTA	TC
S3_GGAGCAATCAATCTCT	Inflam. TC
S3_TGGCGCACAACTGCTA	TC
S3_AGAGCGAAGGGCATGT	Inflam. TC
S3_CCGTTCAAGCCCAATT	TC
S3_GCAGTTAAGCCATCGC	TC
S3_CATGACACATAACCTG	TC
S3_CCGGGATAGTCGCCGT	TC
S3_CCATTCGCATCGATGT	TC
S3_CAGAGAGCAGTCACTA	TC
S3_AGAGCGACAAACTGCT	TC
S3_TCTTTCCCAGCCTTGG	TC
S3_CCTTACGGTGGGTATG	TC
S3_ATGAGGGAGCATCATC	TC
S3_GCTCTGTTCGTCTGAA	TC
S3_GACTACACAGCGTCCA	TC
S3_ACTGAGTTCGAGCCCA	TC
S3_CTGTTTAGTAGGACAC	TC
S11_CGGAGTCTCTCTTATG	NKT
S11_TATGCCCTCACCAGGC	CD40LG+ TC
S11_GCTTCCATCCCATTTA	CD40LG+ TC
S11_CCATTCGTCAGTACGT	NKT
S11_GCTTGAAAGAGAGCTC	NKT
S11_TGTTCCGTCTCGCTTG	CD40LG+ TC
S11_GATGAAAGTAGGAGTC	NKT
S11_GATCGCGGTTTCCACC	CD40LG+ TC
S11_GATGAAATCCCGGATG	CD40LG+ TC
S11_AGGCCGTTCGGCGCAT	NKT
S11_TGCCAAACATTCTTAC	CD40LG+ TC
S11_CTCATTACAGCGATCC	CD40LG+ TC
S11_ACTGTCCTCCTTGGTC	TC
S11_CATTCGCAGTAGATGT	NKT
S11_GCCTCTACAAACTGCT	CD40LG+ TC
S11_CGAATGTAGTACGATA	CD40LG+ TC
S11_CTTAACTCAGGCGATA	TC
S11_CCTCTGACACGACTCG	NKT
S11_TGCGTGGCAATGACCT	TC
S11_CGGACGTCATCACGTA	CD40LG+ TC
S11_GCAAACTAGTGGGATC	TC
S11_GCTTCCACATCCGCGA	TC
S11_CGAGCCACACCAGATT	TC
S11_GATCAGTAGCTCCTTC	TC
S11_CATGACATCAGAGACG	CD40LG+ TC
S11_ACTATCTCACAGACAG	TC
S11_TAAACCGAGCAGCGTA	TC
S11_TACAGTGTCGCGGATC	NKT
S11_CGTGTAAGTGTTCGAT	TC
S11_CTGAAACTCGATAGAA	NKT
S11_TCGCGTTAGTACGACG	CD40LG+ TC
S11_ACTTGTTGTACCGGCT	NKT
S11_GTGCATAGTCAGAGGT	CD40LG+ TC
S11_CGTGTAACATGAGCGA	CD40LG+ TC
S11_GAGGTGAGTAAGTGGC	CD40LG+ TC
S11_TACGGTAGTAAACGCG	TC
S11_CAGCTGGCAAACTGCT	CD40LG+ TC
S11_CGTTCTGAGTTCGATC	TC
S11_TGTATTCAGTCTTGCA	TC
S11_TCGGTAACAAACTGCT	Inflam. TC
S14_CCTTCGATCTAACTGG	TC
S14_ACTGCTCCACCAACCG	NKT
S14_GTCACAAGTGTTGGGA	CD40LG+ TC
S14_CCATTCGTCCTTGACC	CD40LG+ TC
S14_CATCGGGTCAGCTCGG	Inflam. TC
S14_TCTATTGTCCGCGTTT	TC
S14_CAAGTTGGTAGCTGCC	CD40LG+ TC
S14_ATGCGATTCCAATGGT	CD40LG+ TC
S14_ACGGGCTCATCGACGC	CD40LG+ TC
S14_TCTGGAAGTTGCGTTA	CD40LG+ TC
S14_GCGAGAAAGTATCGAA	CD40LG+ TC
S14_CGGCTAGGTAGAAAGG	TC
S14_GACAGAGTCTTTACAC	CD40LG+ TC
S14_TCCACACGTTGACGTT	CD40LG+ TC
S14_CACACAAGTTCTGGTA	CD40LG+ TC
S14_TGTGGTATCATGCAAC	NKT
S14_CAAGAAACAATCTACG	NKT
S14_ACTATCTCACCACCAG	CD40LG+ TC
S14_CGGTTAACAGTAGAGC	CD40LG+ TC
S14_GTACGTACAGAGCCAA	TC
S14_GCAAACTTCTTGTATC	Inflam. TC
S14_CGAGCCAAGTCCGTAT	NKT
S14_AGATTGCAGCAGCGTA	CD40LG+ TC
S14_TGAAAGAAGCCGGTAA	NKT
S14_GCCAAATGTCCTAGCG	CD40LG+ TC
S14_TGGTTAGCAAGCTGGA	TC
S14_CCATGTCTCAACCAAC	NKT
S14_GGATTACAGGTGCAAC	CD40LG+ TC
S14_CTGATAGTCGGAGGTA	TC
S14_AACTTTCAGCTGGAAC	NKT
S14_ATTTCTGCAAAGGCGT	CD40LG+ TC
S14_TAGAGCTGTACTTGAC	TC
S14_AAGACCTTCATCGCTC	Inflam. TC
S14_ACTGAGTGTTGCGTTA	CD40LG+ TC
S14_TGGCCAGTCGGCTTGG	CD40LG+ TC
S14_TCCACACCATACTCTT	CD40LG+ TC
S14_TACTTGTGTCTTCAAG	TC
S14_CTCGTACAGGGTTTCT	TC
S14_GTACTTTAGGCTAGAC	TC
S14_TGTGTTTAGAACTGTA	TC
S14_TCGTAGACATGCAACT	NKT
S14_CGGACGTAGACTCGGA	CD40LG+ TC
S14_GACGTTAGTCCGAATT	TC
S14_CCCTCCTTCCTTAATC	TC
S14_TCAGCAAAGTGTGGCA	TC
S14_AGCGTCGCAGTATCTG	CD40LG+ TC
S14_TTAGGCAAGTGATCGG	NKT
S14_ACACCGGTCTTAGAGC	TC
S14_TTAGTTCTCGCCGTGA	CD40LG+ TC
S14_CGCGTTTAGACCCACC	TC
S14_GATCGATAGTGCCATT	TC
S14_ATTTCTGCAGTTCCCT	NKT
S14_ATGAGGGGTGGCAAAC	CD40LG+ TC
S14_TTGACTTTCTTTAGGG	Inflam. TC
S14_GATGAGGTCGTTTAGG	TC
S14_GAAATGACAAGTACCT	CD40LG+ TC
S14_ATTGGTGAGAGTGACC	CD40LG+ TC
S14_CATGCCTGTGCACCAC	TC
S14_CAACCTCTCACCAGGC	TC
S14_CTGTGCTTCTAGAGTC	Inflam. TC
S14_ACAGCCGGTCCGTGAC	TC
S14_AAACCTGGTTCCACAA	TC
S14_GTCAAGTGTAGAAAGG	TC
S14_GTACGTACAGCATACT	TC
S14_AGTAGTCGTAAGCACG	TC
S14_GGGCATCGTCTCATCC	TC
S14_CCGTACTTCGGATGGA	TC
S14_TTGTAGGTCCGCAAGC	TC
S14_CATTATCGTAATCACC	TC
S14_TCTGGAATCGGTTAAC	TC
S14_GCGCAACAGAAACGCC	NKT
S14_ACCCACTAGATCGGGT	CD40LG+ TC
S14_ATTATCCAGCCGATTT	Inflam. TC
S14_GTCACGGTCGGTGTTA	TC
S14_CTCTGGTCAAGCTGTT	TC
S15_GGACGTCGTCAGCTAT	CD40LG+ TC
S15_TGGGAAGAGCAGATCG	TC
S15_AAGGCAGAGTATTGGA	CD40LG+ TC
S15_GTCTCGTCATCTCGCT	CD40LG+ TC
S15_CTAAGACCATCTCCCA	CD40LG+ TC
S15_GCAGTTAAGATGAGAG	CD40LG+ TC
S15_ACCTTTAAGAAACCAT	CD40LG+ TC
S15_CGATGGCAGTTAGGTA	CD40LG+ TC
S15_GGGTCTGAGGTGCAAC	TC
S15_GACTGCGTCTGCCAGG	CD40LG+ TC
S15_AGGCCGTGTGTGCCTG	TC
S15_GAGCAGATCGTTACGA	TC
S15_GTCTCGTGTGACCAAG	CD40LG+ TC
S15_TGTGTTTCACCAGGCT	CD40LG+ TC
S15_GAGTCCGAGCACGCCT	TC
S15_AAACGGGGTAGCCTCG	NKT
S15_TGACTAGAGCGACGTA	TC
S15_GGCTCGATCGCGATCG	TC
S15_TGAAAGACAAAGCGGT	CD40LG+ TC
S15_CCAATCCTCGTGGGAA	CD40LG+ TC
S15_AGGGAGTAGCTGAAAT	CD40LG+ TC
S15_CACACTCCAAGAAAGG	CD40LG+ TC
S15_TCAGCAAAGATGTAAC	TC
S15_TGCCCATTCGCAAGCC	CD40LG+ TC
S15_CTAACTTTCCGAACGC	TC
S15_TTCTCAACATTCTTAC	TC
S15_TCAGCTCAGCTCCCAG	Inflam. TC
S15_GCAGTTATCGCCCTTA	TC
S15_ACGCAGCAGTGGGTTG	TC
S15_CCGTACTTCTGCTTGC	TC
S15_GGCCGATGTGTGCCTG	CD40LG+ TC
S15_AGGCCACGTTCTCATT	TC
S15_CTGATCCTCATGTCCC	CD40LG+ TC
S15_CCATGTCTCTGCTGCT	TC
S15_CACAGGCAGGCCATAG	Inflam. TC
S15_TCTATTGTCATCGATG	NKT
S15_GCGCGATGTTGCGCAC	TC
S15_TTCTACAAGTTACGGG	TC
S15_TGACTAGAGCGTCTAT	TC
S15_AGAATAGGTCATGCAT	Inflam. TC
S15_CCGTGGATCCGCATCT	TC
